QuestionNo,StateAb,DivisionID,PollingPlaceNm,YesVotes,YesPercentage,NoVotes,NoPercentage,FormalVotes,FormalPercentage,InformalVotes,InformalPercentage,TotalVotes
1,NSW,119,Abbotsbury,338,24.94,1017,75.06,1355,97.9,29,2.1,1384
1,NSW,144,Abbotsford,1406,53.56,1219,46.44,2625,99.02,26,0.98,2651
1,NSW,144,Abbotsford East,450,53.83,386,46.17,836,99.17,7,0.83,843
1,NSW,126,Aberdare,433,30.62,981,69.38,1414,98.06,28,1.94,1442
1,NSW,135,Aberdeen,137,18.49,604,81.51,741,99.33,5,0.67,746
1,NSW,249,Aberglasslyn,380,36.22,669,63.78,1049,98.41,17,1.59,1066
1,NSW,249,Abermain,198,23.08,660,76.92,858,98.96,9,1.04,867
1,NSW,122,Acacia Gardens,738,43.72,950,56.28,1688,98.2,31,1.8,1719
1,NSW,117,Adaminaby,36,21.18,134,78.82,170,99.42,1,0.58,171
1,NSW,136,Adamstown Heights (Newcastle),788,55.93,621,44.07,1409,98.05,28,1.95,1437
1,NSW,148,Adamstown Heights (Shortland),208,55.32,168,44.68,376,98.69,5,1.31,381
1,NSW,136,Adamstown North,903,56.3,701,43.7,1604,98.47,25,1.53,1629
1,NSW,136,Adamstown South,1019,60.05,678,39.95,1697,98.72,22,1.28,1719
1,NSW,117,Adelong,83,19.12,351,80.88,434,99.09,4,0.91,438
1,NSW,131,Airds,411,37.95,672,62.05,1083,98.72,14,1.28,1097
1,NSW,131,Airds North,208,58.43,148,41.57,356,99.16,3,0.84,359
1,NSW,150,Albion Park,379,37.01,645,62.99,1024,98.56,15,1.44,1039
1,NSW,150,Albion Park Heights,626,34.76,1175,65.24,1801,98.09,35,1.91,1836
1,NSW,150,Albion Park PPVC,2697,27.25,7200,72.75,9897,98.76,124,1.24,10021
1,NSW,150,Albion Park Rail,534,34.95,994,65.05,1528,98.26,27,1.74,1555
1,NSW,150,Albion Park South,505,41.91,700,58.09,1205,98.37,20,1.63,1225
1,NSW,118,Albury,851,53.15,750,46.85,1601,98.46,25,1.54,1626
1,NSW,118,Albury Central,428,52.32,390,47.68,818,97.03,25,2.97,843
1,NSW,118,Albury East,320,43.42,417,56.58,737,98.4,12,1.6,749
1,NSW,118,Albury FARRER PPVC,4457,31.65,9625,68.35,14082,99.33,95,0.67,14177
1,NSW,118,Albury North,403,34.01,782,65.99,1185,98.26,21,1.74,1206
1,NSW,118,Albury West,392,45.69,466,54.31,858,99.08,8,0.92,866
1,NSW,113,Aldavilla,151,23.48,492,76.52,643,97.28,18,2.72,661
1,NSW,250,Alectown,19,15.2,106,84.8,125,100,0,0,125
1,NSW,149,Alexandria,726,83.07,148,16.93,874,99.77,2,0.23,876
1,NSW,149,Alexandria South,980,83.26,197,16.74,1177,99.49,6,0.51,1183
1,NSW,124,Alfords Point,541,32.69,1114,67.31,1655,99.16,14,0.84,1669
1,NSW,151,Allambie,365,57.21,273,42.79,638,99.22,5,0.78,643
1,NSW,151,Allambie Heights,1324,59.67,895,40.33,2219,98.93,24,1.07,2243
1,NSW,103,Allawah,466,38.26,752,61.74,1218,89.23,147,10.77,1365
1,NSW,103,Allawah South,347,42.16,476,57.84,823,98.56,12,1.44,835
1,NSW,138,Alstonville,720,48.06,778,51.94,1498,99.27,11,0.73,1509
1,NSW,131,Ambarvale,564,36.94,963,63.06,1527,97.95,32,2.05,1559
1,NSW,131,Ambarvale West,611,65.91,316,34.09,927,97.99,19,2.01,946
1,NSW,249,Anna Bay,515,37.37,863,62.63,1378,98.43,22,1.57,1400
1,NSW,121,Annandale (Grayndler),1236,82.62,260,17.38,1496,99.14,13,0.86,1509
1,NSW,149,Annandale (Sydney),114,87.02,17,12.98,131,100,0,0,131
1,NSW,121,Annandale Central,196,82.01,43,17.99,239,98.35,4,1.65,243
1,NSW,121,Annandale North,1260,83.83,243,16.17,1503,99.21,12,0.79,1515
1,NSW,106,Annangrove (Berowra),268,30.04,624,69.96,892,99.33,6,0.67,898
1,NSW,134,Annangrove (Mitchell),107,39.05,167,60.95,274,99.64,1,0.36,275
1,NSW,125,Appin,322,24.75,979,75.25,1301,98.56,19,1.44,1320
1,NSW,117,Araluen,60,54.05,51,45.95,111,98.23,2,1.77,113
1,NSW,106,Arcadia,280,38.15,454,61.85,734,98.92,8,1.08,742
1,NSW,126,Arcadia Vale,256,37.76,422,62.24,678,99.56,3,0.44,681
1,NSW,250,Ardlethan,67,20.68,257,79.32,324,98.18,6,1.82,330
1,NSW,126,Argenton,213,32.97,433,67.03,646,98.63,9,1.37,655
1,NSW,250,Ariah Park,50,18.12,226,81.88,276,99.64,1,0.36,277
1,NSW,135,Armidale,871,50.97,838,49.03,1709,98.96,18,1.04,1727
1,NSW,135,Armidale PPVC,3879,35,7205,65,11084,99.13,97,0.87,11181
1,NSW,135,Armidale South,361,59.08,250,40.92,611,99.51,3,0.49,614
1,NSW,135,Armidale West,557,47.2,623,52.8,1180,98.91,13,1.09,1193
1,NSW,104,Arncliffe,395,42.89,526,57.11,921,95.74,41,4.26,962
1,NSW,104,Arncliffe Central,590,45.74,700,54.26,1290,97.58,32,2.42,1322
1,NSW,104,Arncliffe North,120,64.86,65,35.14,185,97.88,4,2.12,189
1,NSW,104,Arncliffe West,727,39.36,1120,60.64,1847,97.01,57,2.99,1904
1,NSW,111,Arndell Park North,797,44.75,984,55.25,1781,98.23,32,1.77,1813
1,NSW,137,Artarmon,643,61.3,406,38.7,1049,98.96,11,1.04,1060
1,NSW,137,Artarmon Central,1121,62.04,686,37.96,1807,98.85,21,1.15,1828
1,NSW,251,Ashbury,904,56.15,706,43.85,1610,98.89,18,1.11,1628
1,NSW,153,Ashcroft,365,38.18,591,61.82,956,96.37,36,3.63,992
1,NSW,121,Ashfield (Grayndler),576,65.53,303,34.47,879,99.55,4,0.45,883
1,NSW,251,Ashfield (Watson),387,60.75,250,39.25,637,98.61,9,1.39,646
1,NSW,121,Ashfield East (Grayndler),296,65.78,154,34.22,450,99.56,2,0.44,452
1,NSW,251,Ashfield East (Watson),200,67.57,96,32.43,296,98.67,4,1.33,300
1,NSW,121,Ashfield GRAYNDLER PPVC,3657,61.95,2246,38.05,5903,98.71,77,1.29,5980
1,NSW,121,Ashfield North (Grayndler),635,72.41,242,27.59,877,99.21,7,0.79,884
1,NSW,144,Ashfield North (Reid),128,66.32,65,33.68,193,98.47,3,1.53,196
1,NSW,144,Ashfield REID PPVC,1997,44.01,2541,55.99,4538,98.91,50,1.09,4588
1,NSW,121,Ashfield South (Grayndler),537,80.63,129,19.37,666,99.11,6,0.89,672
1,NSW,251,Ashfield South (Watson),441,67.23,215,32.77,656,98.8,8,1.2,664
1,NSW,251,Ashfield WATSON PPVC,3353,48.72,3529,51.28,6882,98.92,75,1.08,6957
1,NSW,135,Ashford,42,10.55,356,89.45,398,99.5,2,0.5,400
1,NSW,139,Ashley,11,8.15,124,91.85,135,100,0,0,135
1,NSW,250,Ashmont,330,31.95,703,68.05,1033,98.1,20,1.9,1053
1,NSW,249,Ashtonfield,326,39.18,506,60.82,832,98.81,10,1.19,842
1,NSW,106,Asquith (Berowra),592,59.68,400,40.32,992,98.71,13,1.29,1005
1,NSW,108,Asquith (Bradfield),630,56.6,483,43.4,1113,99.02,11,0.98,1124
1,NSW,135,Attunga,53,17.1,257,82.9,310,99.36,2,0.64,312
1,NSW,107,Auburn,1058,55.02,865,44.98,1923,95.53,90,4.47,2013
1,NSW,107,Auburn Central,204,38.27,329,61.73,533,94.67,30,5.33,563
1,NSW,107,Auburn East,273,40.15,407,59.85,680,95.91,29,4.09,709
1,NSW,107,Auburn North,725,52.01,669,47.99,1394,97.76,32,2.24,1426
1,NSW,107,Auburn West,847,42.73,1135,57.27,1982,94.88,107,5.12,2089
1,NSW,114,Austinmer,639,77.83,182,22.17,821,99.03,8,0.97,829
1,NSW,153,Austral,745,38.66,1182,61.34,1927,98.57,28,1.43,1955
1,NSW,132,Avalon,992,62.16,604,37.84,1596,98.58,23,1.42,1619
1,NSW,132,Avalon Beach,366,64.21,204,35.79,570,98.79,7,1.21,577
1,NSW,132,Avalon South,321,71.49,128,28.51,449,97.82,10,2.18,459
1,NSW,150,Avoca,66,42.04,91,57.96,157,99.37,1,0.63,158
1,NSW,146,Avoca Beach,1035,59.38,708,40.62,1743,98.64,24,1.36,1767
1,NSW,139,Baan Baa,26,24.76,79,75.24,105,99.06,1,0.94,106
1,NSW,151,Balgowlah,687,60.58,447,39.42,1134,98.78,14,1.22,1148
1,NSW,151,Balgowlah East,496,64.75,270,35.25,766,99.74,2,0.26,768
1,NSW,151,Balgowlah Heights,1179,64.82,640,35.18,1819,99.29,13,0.71,1832
1,NSW,114,Balgownie,580,57.54,428,42.46,1008,99.12,9,0.88,1017
1,NSW,114,Balgownie Central,618,48.93,645,51.07,1263,98.59,18,1.41,1281
1,NSW,139,Ballimore,13,13.4,84,86.6,97,100,0,0,97
1,NSW,145,Ballina,1274,49.59,1295,50.41,2569,97.75,59,2.25,2628
1,NSW,145,Ballina East,445,44.46,556,55.54,1001,98.72,13,1.28,1014
1,NSW,145,Ballina North,163,50.15,162,49.85,325,99.09,3,0.91,328
1,NSW,138,Ballina PAGE PPVC,1160,35.07,2148,64.93,3308,99.28,24,0.72,3332
1,NSW,145,Ballina RICHMOND PPVC,4473,37.66,7405,62.34,11878,98.87,136,1.13,12014
1,NSW,145,Ballina West,239,38.67,379,61.33,618,99.36,4,0.64,622
1,NSW,121,Balmain,368,75.26,121,24.74,489,98.59,7,1.41,496
1,NSW,121,Balmain Central,1377,77.36,403,22.64,1780,99.55,8,0.45,1788
1,NSW,121,Balmain East,635,76.32,197,23.68,832,99.64,3,0.36,835
1,NSW,151,Balmoral,303,57.93,220,42.07,523,95.26,26,4.74,549
1,NSW,118,Balranald,66,12.69,454,87.31,520,99.24,4,0.76,524
1,NSW,145,Bangalow,845,69.32,374,30.68,1219,98.54,18,1.46,1237
1,NSW,124,Bangor,829,39.09,1292,60.91,2121,99.44,12,0.56,2133
1,NSW,124,Bangor North,202,43.63,261,56.37,463,100,0,0,463
1,NSW,124,Bangor South,167,43.49,217,56.51,384,98.46,6,1.54,390
1,NSW,127,Banksmeadow,754,55.12,614,44.88,1368,99.13,12,0.87,1380
1,NSW,107,Bankstown (Blaxland),578,48.29,619,51.71,1197,96.14,48,3.86,1245
1,NSW,251,Bankstown (Watson),101,42.62,136,57.38,237,94.8,13,5.2,250
1,NSW,103,Bankstown BANKS PPVC,195,38.39,313,61.61,508,97.5,13,2.5,521
1,NSW,107,Bankstown BLAXLAND PPVC,4672,40.69,6809,59.31,11481,98.23,207,1.77,11688
1,NSW,107,Bankstown Central (Blaxland),524,43.09,692,56.91,1216,95.52,57,4.48,1273
1,NSW,251,Bankstown Central (Watson),162,35.76,291,64.24,453,94.97,24,5.03,477
1,NSW,107,Bankstown East,668,49.81,673,50.19,1341,96.2,53,3.8,1394
1,NSW,107,Bankstown North,310,40.95,447,59.05,757,96.68,26,3.32,783
1,NSW,251,Bankstown South,265,32.56,549,67.44,814,95.54,38,4.46,852
1,NSW,251,Bankstown WATSON PPVC,2105,38.69,3336,61.31,5441,97.72,127,2.28,5568
1,NSW,107,Bankstown West,451,35.37,824,64.63,1275,96.44,47,3.56,1322
1,NSW,145,Banora Point,266,33.59,526,66.41,792,98.26,14,1.74,806
1,NSW,145,Banora Point North,337,34.35,644,65.65,981,98.49,15,1.51,996
1,NSW,145,Banora Point South,514,37.91,842,62.09,1356,98.4,22,1.6,1378
1,NSW,145,Banora Point West,365,32.3,765,67.7,1130,98.26,20,1.74,1150
1,NSW,139,Baradine,78,14.61,456,85.39,534,98.89,6,1.11,540
1,NSW,149,Barangaroo,623,56.03,489,43.97,1112,98.84,13,1.16,1125
1,NSW,124,Barden Ridge,570,32.97,1159,67.03,1729,99.03,17,0.97,1746
1,NSW,131,Bardia (Macarthur),52,52,48,48,100,99.01,1,0.99,101
1,NSW,153,Bardia (Werriwa),953,51.26,906,48.74,1859,98.26,33,1.74,1892
1,NSW,104,Bardwell Park,444,43.92,567,56.08,1011,98.35,17,1.65,1028
1,NSW,118,Barellan,58,20.07,231,79.93,289,98.97,3,1.03,292
1,NSW,125,Bargo,240,24.95,722,75.05,962,98.06,19,1.94,981
1,NSW,125,Bargo Central,103,19.69,420,80.31,523,99.81,1,0.19,524
1,NSW,118,Barham,139,16.05,727,83.95,866,99.43,5,0.57,871
1,NSW,250,Barmedman,24,18.9,103,81.1,127,100,0,0,127
1,NSW,126,Barnsley,286,27.24,764,72.76,1050,98.59,15,1.41,1065
1,NSW,118,Barooga,119,20.52,461,79.48,580,99.32,4,0.68,584
1,NSW,135,Barraba,185,20.33,725,79.67,910,99.02,9,0.98,919
1,NSW,150,Barrack Heights,302,38.52,482,61.48,784,98,16,2,800
1,NSW,130,Barrington,56,43.41,73,56.59,129,99.23,1,0.77,130
1,NSW,109,Barry,54,28.27,137,71.73,191,100,0,0,191
1,NSW,120,Basin View,193,33.57,382,66.43,575,99.14,5,0.86,580
1,NSW,107,Bass Hill,490,28.69,1218,71.31,1708,96.33,65,3.67,1773
1,NSW,107,Bass Hill Central,156,29.38,375,70.62,531,97.07,16,2.93,547
1,NSW,107,Bass Hill West,610,26.71,1674,73.29,2284,97.15,67,2.85,2351
1,NSW,115,Bateau Bay Central,171,37.34,287,62.66,458,99.35,3,0.65,461
1,NSW,115,Bateau Bay East,884,46.38,1022,53.62,1906,98.65,26,1.35,1932
1,NSW,115,Bateau Bay South,120,49.18,124,50.82,244,98.79,3,1.21,247
1,NSW,120,Batehaven,338,40.19,503,59.81,841,98.48,13,1.52,854
1,NSW,120,Batemans Bay,400,31.55,868,68.45,1268,97.69,30,2.31,1298
1,NSW,120,Batemans Bay PPVC,3373,32.99,6852,67.01,10225,99.11,92,0.89,10317
1,NSW,109,Bathurst,363,39.33,560,60.67,923,97.06,28,2.94,951
1,NSW,109,Bathurst Central,570,40.71,830,59.29,1400,98.45,22,1.55,1422
1,NSW,109,Bathurst City,472,35.95,841,64.05,1313,98.06,26,1.94,1339
1,NSW,109,Bathurst North,225,42.45,305,57.55,530,99.81,1,0.19,531
1,NSW,109,Bathurst PPVC,3222,25.77,9282,74.23,12504,98.63,174,1.37,12678
1,NSW,109,Bathurst South,253,37.48,422,62.52,675,98.83,8,1.17,683
1,NSW,109,Bathurst West,434,35.93,774,64.07,1208,98.29,21,1.71,1229
1,NSW,117,Batlow,118,27.51,311,72.49,429,98.85,5,1.15,434
1,NSW,134,Baulkham Hills,1329,47.65,1460,52.35,2789,99.22,22,0.78,2811
1,NSW,106,Baulkham Hills BEROWRA PPVC,365,26.15,1031,73.85,1396,99.01,14,0.99,1410
1,NSW,134,Baulkham Hills Central,477,46.22,555,53.78,1032,99.04,10,0.96,1042
1,NSW,134,Baulkham Hills City,491,44.88,603,55.12,1094,98.92,12,1.08,1106
1,NSW,122,Baulkham Hills GREENWAY PPVC,794,42.64,1068,57.36,1862,98.83,22,1.17,1884
1,NSW,134,Baulkham Hills MITCHELL PPVC,6633,35.51,12048,64.49,18681,99.33,126,0.67,18807
1,NSW,134,Baulkham Hills North,1184,46,1390,54,2574,98.96,27,1.04,2601
1,NSW,134,Baulkham Hills North West,169,52,156,48,325,99.39,2,0.61,327
1,NSW,140,Baulkham Hills PARRAMATTA PPVC,258,36.39,451,63.61,709,98.47,11,1.53,720
1,NSW,134,Baulkham Hills South,530,41.05,761,58.95,1291,99.46,7,0.54,1298
1,NSW,134,Baulkham Hills South West,217,52.67,195,47.33,412,98.33,7,1.67,419
1,NSW,134,Baulkham Hills West,695,44.9,853,55.1,1548,99.23,12,0.77,1560
1,NSW,120,Bawley Point,224,50.79,217,49.21,441,96.5,16,3.5,457
1,NSW,113,Bayldon,657,34.76,1233,65.24,1890,98.28,33,1.72,1923
1,NSW,132,Bayview,543,56.56,417,43.44,960,99.28,7,0.72,967
1,NSW,132,Beacon Hill (Mackellar),665,51,639,49,1304,95.81,57,4.19,1361
1,NSW,151,Beacon Hill (Warringah),263,51.77,245,48.23,508,97.32,14,2.68,522
1,NSW,149,Beaconsfield,512,67.9,242,32.1,754,99.34,5,0.66,759
1,NSW,134,Beaumont Hills,1540,59.99,1027,40.01,2567,98.96,27,1.04,2594
1,NSW,134,Beaumont Hills Central,661,44.33,830,55.67,1491,98.87,17,1.13,1508
1,NSW,136,Beaumont Park,307,52.93,273,47.07,580,98.14,11,1.86,591
1,NSW,151,Beauty Point,461,55.88,364,44.12,825,98.92,9,1.08,834
1,NSW,250,Bedgerabong,13,13.4,84,86.6,97,98.98,1,1.02,98
1,NSW,130,Beechwood,120,22.43,415,77.57,535,97.81,12,2.19,547
1,NSW,106,Beecroft,1284,56.22,1000,43.78,2284,99.3,16,0.7,2300
1,NSW,106,Beecroft North,126,53.85,108,46.15,234,99.57,1,0.43,235
1,NSW,118,Beelbangera,118,22.22,413,77.78,531,99.44,3,0.56,534
1,NSW,117,Bega,240,45.54,287,54.46,527,99.25,4,0.75,531
1,NSW,117,Bega Central,143,48.31,153,51.69,296,98.34,5,1.66,301
1,NSW,117,Bega Heights,279,42.53,377,57.47,656,98.8,8,1.2,664
1,NSW,117,Bega PPVC,2208,37.86,3624,62.14,5832,98.95,62,1.05,5894
1,NSW,117,Belconnen EDEN-MONARO PPVC,190,51.77,177,48.23,367,98.66,5,1.34,372
1,NSW,251,Belfield,124,46.27,144,53.73,268,99.26,2,0.74,270
1,NSW,134,Bella Vista,606,49.31,623,50.69,1229,99.11,11,0.89,1240
1,NSW,134,Bella Vista North,1247,42.75,1670,57.25,2917,98.65,40,1.35,2957
1,NSW,114,Bellambi,265,56.62,203,43.38,468,97.7,11,2.3,479
1,NSW,139,Bellata,6,4.26,135,95.74,141,99.3,1,0.7,142
1,NSW,126,Bellbird,288,27.02,778,72.98,1066,98.7,14,1.3,1080
1,NSW,113,Bellbrook,26,27.37,69,72.63,95,98.96,1,1.04,96
1,NSW,152,Bellevue Hill,1107,61.43,695,38.57,1802,98.74,23,1.26,1825
1,NSW,152,Bellevue Hill South,506,50.2,502,49.8,1008,98.82,12,1.18,1020
1,NSW,113,Bellingen,1345,65.93,695,34.07,2040,97.89,44,2.11,2084
1,NSW,113,Bellingen North,89,67.42,43,32.58,132,100,0,0,132
1,NSW,148,Belmont,134,37.22,226,62.78,360,99.45,2,0.55,362
1,NSW,148,Belmont Central,439,40.42,647,59.58,1086,98.46,17,1.54,1103
1,NSW,148,Belmont North,361,37.14,611,62.86,972,98.18,18,1.82,990
1,NSW,148,Belmont PPVC,4385,30.85,9829,69.15,14214,98.99,145,1.01,14359
1,NSW,148,Belmont West,229,38.42,367,61.58,596,97.7,14,2.3,610
1,NSW,104,Belmore BARTON PPVC,843,31,1876,69,2719,98.84,32,1.16,2751
1,NSW,251,Belmore Central,375,39.89,565,60.11,940,97.81,21,2.19,961
1,NSW,251,Belmore North,724,43.2,952,56.8,1676,97.84,37,2.16,1713
1,NSW,251,Belmore South,483,39.56,738,60.44,1221,97.76,28,2.24,1249
1,NSW,251,Belmore WATSON PPVC,5032,36.93,8593,63.07,13625,98.3,235,1.7,13860
1,NSW,132,Belrose,1160,51.72,1083,48.28,2243,98.9,25,1.1,2268
1,NSW,132,Belrose North,754,45.31,910,54.69,1664,99.11,15,0.89,1679
1,NSW,117,Bemboka,95,33.69,187,66.31,282,98.95,3,1.05,285
1,NSW,135,Ben Lomond,13,11.82,97,88.18,110,99.1,1,0.9,111
1,NSW,135,Ben Venue,481,48.54,510,51.46,991,98.61,14,1.39,1005
1,NSW,135,Bendemeer,49,18.99,209,81.01,258,98.85,3,1.15,261
1,NSW,146,Bensville,170,43.26,223,56.74,393,99.49,2,0.51,395
1,NSW,138,Bentley,55,28.8,136,71.2,191,100,0,0,191
1,NSW,107,Berala,634,46.72,723,53.28,1357,96.65,47,3.35,1404
1,NSW,107,Berala BLAXLAND PPVC,4686,40.18,6977,59.82,11663,97.97,242,2.03,11905
1,NSW,140,Berala PARRAMATTA PPVC,349,36.66,603,63.34,952,97.54,24,2.46,976
1,NSW,144,Berala REID PPVC,948,42.78,1268,57.22,2216,99.02,22,0.98,2238
1,NSW,107,Berala South,509,41.45,719,58.55,1228,97.38,33,2.62,1261
1,NSW,251,Berala WATSON PPVC,420,42.94,558,57.06,978,98.19,18,1.81,996
1,NSW,249,Beresfield,475,28.32,1202,71.68,1677,98.3,29,1.7,1706
1,NSW,150,Berkeley,390,34.18,751,65.82,1141,98.28,20,1.72,1161
1,NSW,150,Berkeley South,292,36.92,499,63.08,791,98.51,12,1.49,803
1,NSW,115,Berkeley Vale,784,41.93,1086,58.07,1870,98.84,22,1.16,1892
1,NSW,115,Berkeley Vale North,223,36.5,388,63.5,611,99.51,3,0.49,614
1,NSW,150,Berkeley West,438,38.19,709,61.81,1147,98.79,14,1.21,1161
1,NSW,128,Berkshire Park,53,13.59,337,86.41,390,99.49,2,0.51,392
1,NSW,117,Bermagui,629,52.2,576,47.8,1205,98.61,17,1.39,1222
1,NSW,106,Berowra,1092,54.22,922,45.78,2014,98.82,24,1.18,2038
1,NSW,106,Berowra Heights,712,61.38,448,38.62,1160,99.06,11,0.94,1171
1,NSW,106,Berowra PPVC,1691,46.84,1919,53.16,3610,99.26,27,0.74,3637
1,NSW,117,Berridale,185,45.68,220,54.32,405,99.75,1,0.25,406
1,NSW,118,Berrigan,108,16.19,559,83.81,667,99.11,6,0.89,673
1,NSW,150,Berrima,197,40.37,291,59.63,488,99.39,3,0.61,491
1,NSW,120,Berry,788,53.39,688,46.61,1476,99.46,8,0.54,1484
1,NSW,104,Beverly Hills,315,31.31,691,68.69,1006,99.31,7,0.69,1013
1,NSW,104,Beverly Hills Central,198,39.29,306,60.71,504,98.44,8,1.56,512
1,NSW,103,Beverly Hills North (Banks),92,33.45,183,66.55,275,97.17,8,2.83,283
1,NSW,251,Beverly Hills North (Watson),632,35.45,1151,64.55,1783,97.7,42,2.3,1825
1,NSW,103,Beverly Hills South (Banks),191,44.21,241,55.79,432,97.74,10,2.26,442
1,NSW,104,Beverly Hills South (Barton),274,40.9,396,59.1,670,97.67,16,2.33,686
1,NSW,138,Bexhill,192,41.92,266,58.08,458,98.92,5,1.08,463
1,NSW,104,Bexley,619,40.8,898,59.2,1517,96.99,47,3.01,1564
1,NSW,104,Bexley Central,257,42.76,344,57.24,601,99.83,1,0.17,602
1,NSW,104,Bexley East,452,44.53,563,55.47,1015,97.22,29,2.78,1044
1,NSW,104,Bexley North,522,48.83,547,51.17,1069,98.07,21,1.93,1090
1,NSW,104,Bexley North Park,605,40.6,885,59.4,1490,98.68,20,1.32,1510
1,NSW,104,Bexley South,271,42.54,366,57.46,637,97.55,16,2.45,653
1,NSW,104,Bexley West,484,29.95,1132,70.05,1616,96.48,59,3.52,1675
1,NSW,111,Bidwill,376,35.71,677,64.29,1053,98.23,19,1.77,1072
1,NSW,125,Bigga,9,7.14,117,92.86,126,98.44,2,1.56,128
1,NSW,145,Bilambil,390,38.35,627,61.65,1017,98.55,15,1.45,1032
1,NSW,132,Bilgola Plateau,651,66.7,325,33.3,976,98.99,10,1.01,986
1,NSW,250,Billimari,30,19.23,126,80.77,156,100,0,0,156
1,NSW,145,Billinudgel,316,60.54,206,39.46,522,97.94,11,2.06,533
1,NSW,133,Bilpin,200,45.66,238,54.34,438,99.32,3,0.68,441
1,NSW,117,Binalong,60,29.13,146,70.87,206,99.04,2,0.96,208
1,NSW,125,Binda,42,23.6,136,76.4,178,98.89,2,1.11,180
1,NSW,135,Bingara,144,15.53,783,84.47,927,99.68,3,0.32,930
1,NSW,139,Binnaway,66,17.79,305,82.21,371,99.2,3,0.8,374
1,NSW,126,Biraban,339,34.91,632,65.09,971,97.59,24,2.41,995
1,NSW,121,Birchgrove,1173,78.25,326,21.75,1499,99.34,10,0.66,1509
1,NSW,121,Birchgrove East,552,79.88,139,20.12,691,99.42,4,0.58,695
1,NSW,136,Birmingham Gardens North,433,45.82,512,54.18,945,99.16,8,0.84,953
1,NSW,107,Birrong,834,34.76,1565,65.24,2399,96.66,83,3.34,2482
1,NSW,135,Black Mountain,42,22.11,148,77.89,190,100,0,0,190
1,NSW,109,Black Springs,35,17.77,162,82.23,197,98.5,3,1.5,200
1,NSW,126,Blackalls,326,36.38,570,63.62,896,97.5,23,2.5,919
1,NSW,150,Blackbutt,394,35.4,719,64.6,1113,98.32,19,1.68,1132
1,NSW,111,Blackett,418,38.67,663,61.33,1081,97.83,24,2.17,1105
1,NSW,133,Blackheath,1177,68.91,531,31.09,1708,98.96,18,1.04,1726
1,NSW,148,Blacksmiths,405,51.07,388,48.93,793,98.39,13,1.61,806
1,NSW,122,Blacktown,268,43.16,353,56.84,621,98.89,7,1.11,628
1,NSW,111,Blacktown CHIFLEY PPVC,2339,37.38,3918,62.62,6257,98.96,66,1.04,6323
1,NSW,122,Blacktown East,380,36.47,662,63.53,1042,98.39,17,1.61,1059
1,NSW,122,Blacktown GREENWAY PPVC,3429,36.83,5882,63.17,9311,98.91,103,1.09,9414
1,NSW,315,Blacktown MCMAHON PPVC,219,33.28,439,66.72,658,98.65,9,1.35,667
1,NSW,122,Blacktown North,216,51.55,203,48.45,419,98.13,8,1.87,427
1,NSW,140,Blacktown PARRAMATTA PPVC,459,40.09,686,59.91,1145,99.05,11,0.95,1156
1,NSW,111,Blacktown South (Chifley),176,48.75,185,51.25,361,99.18,3,0.82,364
1,NSW,122,Blacktown South (Greenway),1091,47.27,1217,52.73,2308,98.46,36,1.54,2344
1,NSW,111,Blacktown West,1003,46.5,1154,53.5,2157,98,44,2,2201
1,NSW,135,Blackville,12,25,36,75,48,100,0,0,48
1,NSW,131,Blairmount,487,46.78,554,53.22,1041,97.93,22,2.07,1063
1,NSW,103,Blakehurst North,124,38.04,202,61.96,326,99.09,3,0.91,329
1,NSW,112,Blakehurst South,423,26.81,1155,73.19,1578,99.06,15,0.94,1593
1,NSW,133,Blaxland,441,49.83,444,50.17,885,98.77,11,1.23,896
1,NSW,133,Blaxland East,1212,56.19,945,43.81,2157,98.27,38,1.73,2195
1,NSW,109,Blayney,417,23.44,1362,76.56,1779,98.94,19,1.06,1798
1,NSW,109,Bletchington,676,36.58,1172,63.42,1848,99.09,17,0.91,1865
1,NSW,133,Bligh Park,443,25.77,1276,74.23,1719,98.57,25,1.43,1744
1,NSW,133,Bligh Park East,266,25,798,75,1064,98.43,17,1.57,1081
1,NSW,118,Blighty,8,6.5,115,93.5,123,99.19,1,0.81,124
1,NSW,109,Bloomfield,51,54.26,43,45.74,94,100,0,0,94
1,NSW,115,Blue Haven,549,32.03,1165,67.97,1714,98.51,26,1.49,1740
1,NSW,113,Boambee,507,37.17,857,62.83,1364,98.06,27,1.94,1391
1,NSW,249,Bobs Farm,64,25.6,186,74.4,250,98.43,4,1.57,254
1,NSW,117,Bodalla,139,35.92,248,64.08,387,99.23,3,0.77,390
1,NSW,250,Bogan Gate,27,24.11,85,75.89,112,99.12,1,0.88,113
1,NSW,145,Bogangar,450,50,450,50,900,99.23,7,0.77,907
1,NSW,139,Boggabilla,54,31.95,115,68.05,169,99.41,1,0.59,170
1,NSW,139,Boggabri,50,9.8,460,90.2,510,98.65,7,1.35,517
1,NSW,130,Bolwarra,462,40.85,669,59.15,1131,99.65,4,0.35,1135
1,NSW,120,Bomaderry,591,38.33,951,61.67,1542,98.34,26,1.66,1568
1,NSW,117,Bombala,164,19.85,662,80.15,826,98.57,12,1.43,838
1,NSW,138,Bonalbo,81,26.56,224,73.44,305,99.03,3,0.97,308
1,NSW,152,Bondi,823,74.35,284,25.65,1107,98.58,16,1.42,1123
1,NSW,152,Bondi Beach,1161,73.25,424,26.75,1585,88.85,199,11.15,1784
1,NSW,152,Bondi Beach East,355,79.95,89,20.05,444,98.45,7,1.55,451
1,NSW,152,Bondi Junction,600,68.73,273,31.27,873,98.2,16,1.8,889
1,NSW,127,Bondi Junction KINGSFORD SMITH PPVC,739,56.46,570,43.54,1309,98.64,18,1.36,1327
1,NSW,152,Bondi Junction North,660,65.28,351,34.72,1011,99.31,7,0.69,1018
1,NSW,149,Bondi Junction SYDNEY PPVC,580,55.77,460,44.23,1040,98.86,12,1.14,1052
1,NSW,152,Bondi Junction WENTWORTH PPVC,6354,58.61,4487,41.39,10841,99.21,86,0.79,10927
1,NSW,152,Bondi North,663,70.53,277,29.47,940,98.22,17,1.78,957
1,NSW,152,Bondi South,833,69.19,371,30.81,1204,98.85,14,1.15,1218
1,NSW,152,Bondi Surf,1058,76.45,326,23.55,1384,98.86,16,1.14,1400
1,NSW,126,Bonnells Bay,659,30.67,1490,69.33,2149,98.49,33,1.51,2182
1,NSW,124,Bonnet Bay,575,48.48,611,51.52,1186,99.5,6,0.5,1192
1,NSW,130,Bonny Hills,307,35.91,548,64.09,855,98.73,11,1.27,866
1,NSW,119,Bonnyrigg (Fowler),232,48.74,244,51.26,476,98.14,9,1.86,485
1,NSW,153,Bonnyrigg (Werriwa),173,40.52,254,59.48,427,97.94,9,2.06,436
1,NSW,119,Bonnyrigg Central (Fowler),96,39.34,148,60.66,244,97.21,7,2.79,251
1,NSW,153,Bonnyrigg Central (Werriwa),242,38.72,383,61.28,625,97.96,13,2.04,638
1,NSW,153,Bonnyrigg Heights,546,38.83,860,61.17,1406,97.64,34,2.36,1440
1,NSW,153,Bonnyrigg Heights East,204,32.23,429,67.77,633,99.22,5,0.78,638
1,NSW,135,Bonshaw,5,10,45,90,50,98.04,1,1.96,51
1,NSW,113,Bonville,334,30.25,770,69.75,1104,99.1,10,0.9,1114
1,NSW,146,Booker Bay,205,38.61,326,61.39,531,98.52,8,1.48,539
1,NSW,139,Boomi,3,4.05,71,95.95,74,100,0,0,74
1,NSW,126,Booragul,322,39.13,501,60.87,823,98.44,13,1.56,836
1,NSW,130,Booral,116,24.63,355,75.37,471,98.33,8,1.67,479
1,NSW,125,Boorowa,224,23.41,733,76.59,957,98.97,10,1.03,967
1,NSW,109,Borenore,98,39.04,153,60.96,251,100,0,0,251
1,NSW,119,Bossley Park,421,27.41,1115,72.59,1536,98.34,26,1.66,1562
1,NSW,119,Bossley Park East,363,35.11,671,64.89,1034,97.82,23,2.18,1057
1,NSW,119,Bossley Park South,220,28.99,539,71.01,759,97.31,21,2.69,780
1,NSW,127,Botany,1110,53.14,979,46.86,2089,98.82,25,1.18,2114
1,NSW,127,Botany East,981,50.03,980,49.97,1961,98.1,38,1.9,1999
1,NSW,127,Botany South,96,51.89,89,48.11,185,99.46,1,0.54,186
1,NSW,139,Bourke,110,24.77,334,75.23,444,99.78,1,0.22,445
1,NSW,139,Bourke PPVC,136,20.99,512,79.01,648,99.39,4,0.61,652
1,NSW,109,Bowen,383,34.72,720,65.28,1103,98.66,15,1.34,1118
1,NSW,109,Bowenfels South,64,35.16,118,64.84,182,99.45,1,0.55,183
1,NSW,117,Bowning,52,32.91,106,67.09,158,100,0,0,158
1,NSW,150,Bowral,953,52.31,869,47.69,1822,99.24,14,0.76,1836
1,NSW,150,Bowral East,399,40.8,579,59.2,978,98.09,19,1.91,997
1,NSW,125,Bowral HUME PPVC,661,34.04,1281,65.96,1942,99.18,16,0.82,1958
1,NSW,150,Bowral South,355,45.75,421,54.25,776,98.85,9,1.15,785
1,NSW,150,Bowral WHITLAM PPVC,3906,37.25,6580,62.75,10486,99.13,92,0.87,10578
1,NSW,113,Bowraville,341,36.94,582,63.06,923,98.19,17,1.81,940
1,NSW,134,Box Hill,1010,43.22,1327,56.78,2337,99.07,22,0.93,2359
1,NSW,131,Bradbury,810,34.02,1571,65.98,2381,98.59,34,1.41,2415
1,NSW,125,Bradfordville,185,25.91,529,74.09,714,99.03,7,0.97,721
1,NSW,117,Braidwood,365,46.5,420,53.5,785,94.12,49,5.88,834
1,NSW,117,Braidwood Central,303,62.99,178,37.01,481,99.79,1,0.21,482
1,NSW,126,Branxton,496,27.91,1281,72.09,1777,98.72,23,1.28,1800
1,NSW,144,Breakfast Point,949,46.5,1092,53.5,2041,99.03,20,0.97,2061
1,NSW,117,Bredbo,89,36.48,155,63.52,244,97.21,7,2.79,251
1,NSW,139,Brewarrina,142,34.55,269,65.45,411,98.8,5,1.2,416
1,NSW,104,Brighton North,285,41.85,396,58.15,681,98.7,9,1.3,690
1,NSW,104,Brighton-Le-Sands (Barton),596,37.65,987,62.35,1583,98.08,31,1.92,1614
1,NSW,112,Brighton-Le-Sands (Cook),99,34.86,185,65.14,284,98.61,4,1.39,288
1,NSW,125,Bringelly (Hume),59,12.63,408,87.37,467,99.57,2,0.43,469
1,NSW,153,Bringelly (Werriwa),70,16.2,362,83.8,432,97.52,11,2.48,443
1,NSW,138,Broadwater,126,32.81,258,67.19,384,98.97,4,1.03,388
1,NSW,117,Brogo,65,58.04,47,41.96,112,100,0,0,112
1,NSW,126,Broke,94,30.62,213,69.38,307,98.4,5,1.6,312
1,NSW,139,Broken Hill Alma,195,24.62,597,75.38,792,98.39,13,1.61,805
1,NSW,139,Broken Hill Central,266,34.68,501,65.32,767,98.21,14,1.79,781
1,NSW,139,Broken Hill East,220,25.37,647,74.63,867,98.08,17,1.92,884
1,NSW,139,Broken Hill Excelsior,316,27.05,852,72.95,1168,98.32,20,1.68,1188
1,NSW,139,Broken Hill North,180,25,540,75,720,98.77,9,1.23,729
1,NSW,139,Broken Hill PPVC,1269,19.14,5362,80.86,6631,99.01,66,0.99,6697
1,NSW,152,Bronte,883,74.96,295,25.04,1178,99.24,9,0.76,1187
1,NSW,106,Brooklyn,281,62.44,169,37.56,450,97.4,12,2.6,462
1,NSW,151,Brookvale,716,57.93,520,42.07,1236,97.94,26,2.06,1262
1,NSW,151,Brookvale East,387,64.07,217,35.93,604,98.85,7,1.15,611
1,NSW,132,Brookvale MACKELLAR PPVC,3007,44.63,3730,55.37,6737,98.8,82,1.2,6819
1,NSW,151,Brookvale WARRINGAH PPVC,4397,53.25,3860,46.75,8257,98.92,90,1.08,8347
1,NSW,120,Broulee,497,59.03,345,40.97,842,98.94,9,1.06,851
1,NSW,150,Brownsville,196,41,282,59,478,98.76,6,1.24,484
1,NSW,145,Brunswick Heads,945,63.47,544,36.53,1489,97.77,34,2.23,1523
1,NSW,148,Budgewoi,412,35.03,764,64.97,1176,98,24,2,1200
1,NSW,148,Budgewoi Central,580,43.25,761,56.75,1341,98.97,14,1.03,1355
1,NSW,148,Buff Point,415,32.88,847,67.12,1262,98.9,14,1.1,1276
1,NSW,130,Bulahdelah,192,20.6,740,79.4,932,99.15,8,0.85,940
1,NSW,114,Bulli,423,62.85,250,37.15,673,98.97,7,1.03,680
1,NSW,114,Bulli Central,1295,62.14,789,37.86,2084,98.86,24,1.14,2108
1,NSW,125,Bundanoon,682,53.41,595,46.59,1277,98.84,15,1.16,1292
1,NSW,135,Bundarra,41,11.11,328,88.89,369,99.73,1,0.27,370
1,NSW,124,Bundeena,716,61.41,450,38.59,1166,99.15,10,0.85,1176
1,NSW,117,Bungendore,935,47.56,1031,52.44,1966,98.79,24,1.21,1990
1,NSW,117,Bungendore North,237,47.02,267,52.98,504,99.21,4,0.79,508
1,NSW,125,Bungonia,47,26.11,133,73.89,180,99.45,1,0.55,181
1,NSW,130,Bungwahl,108,41.06,155,58.94,263,99.25,2,0.75,265
1,NSW,118,Bunnaloo,8,19.05,34,80.95,42,100,0,0,42
1,NSW,127,Bunnerong South,314,52.07,289,47.93,603,98.69,8,1.31,611
1,NSW,118,Buronga,169,21.18,629,78.82,798,99.25,6,0.75,804
1,NSW,112,Burraneer,141,42.22,193,57.78,334,98.24,6,1.76,340
1,NSW,112,Burraneer Bay,888,42.8,1187,57.2,2075,98.9,23,1.1,2098
1,NSW,150,Burrawang,186,58.49,132,41.51,318,99.07,3,0.93,321
1,NSW,130,Burrell Creek,56,25.93,160,74.07,216,100,0,0,216
1,NSW,139,Burren Junction,16,11.11,128,88.89,144,98.63,2,1.37,146
1,NSW,120,Burrill Lake,259,43.82,332,56.18,591,98.34,10,1.66,601
1,NSW,145,Burringbar,268,48.91,280,51.09,548,97.16,16,2.84,564
1,NSW,118,Burrumbuttock,32,16.93,157,83.07,189,99.47,1,0.53,190
1,NSW,144,Burwood,864,46.23,1005,53.77,1869,98.52,28,1.48,1897
1,NSW,144,Burwood East,575,49.31,591,50.69,1166,99.07,11,0.93,1177
1,NSW,144,Burwood Park,559,45.86,660,54.14,1219,98.07,24,1.93,1243
1,NSW,125,Buxton,189,23.98,599,76.02,788,99.37,5,0.63,793
1,NSW,145,Byron Bay,960,72.29,368,27.71,1328,97.65,32,2.35,1360
1,NSW,145,Byron Bay PPVC,3658,64.9,1978,35.1,5636,98.45,89,1.55,5725
1,NSW,145,Byron Bay South,393,73.6,141,26.4,534,98.89,6,1.11,540
1,NSW,119,Cabramatta,706,49.86,710,50.14,1416,97.05,43,2.95,1459
1,NSW,119,Cabramatta East,647,47.47,716,52.53,1363,97.71,32,2.29,1395
1,NSW,119,Cabramatta FOWLER PPVC,6647,39.02,10389,60.98,17036,98.2,312,1.8,17348
1,NSW,315,Cabramatta MCMAHON PPVC,402,37.82,661,62.18,1063,98.15,20,1.85,1083
1,NSW,119,Cabramatta South,415,46.32,481,53.68,896,96.34,34,3.66,930
1,NSW,153,Cabramatta WERRIWA PPVC,1620,37.36,2716,62.64,4336,98.72,56,1.28,4392
1,NSW,119,Cabramatta West,430,50.35,424,49.65,854,98.39,14,1.61,868
1,NSW,119,Cabramatta West Central,536,40.73,780,59.27,1316,97.27,37,2.73,1353
1,NSW,135,Calala,207,22.57,710,77.43,917,99.57,4,0.43,921
1,NSW,109,Calare Central,417,39.04,651,60.96,1068,98.16,20,1.84,1088
1,NSW,120,Callala Bay,368,39.11,573,60.89,941,98.95,10,1.05,951
1,NSW,120,Callala Beach,132,39.76,200,60.24,332,99.1,3,0.9,335
1,NSW,120,Cambewarra,318,47.25,355,52.75,673,98.97,7,1.03,680
1,NSW,128,Cambridge Gardens,470,28.35,1188,71.65,1658,97.99,34,2.01,1692
1,NSW,128,Cambridge Park,598,30.97,1333,69.03,1931,98.42,31,1.58,1962
1,NSW,128,Cambridge Park North,91,32.5,189,67.5,280,100,0,0,280
1,NSW,128,Cambridge Park South,347,30.84,778,69.16,1125,98.86,13,1.14,1138
1,NSW,125,Camden,575,31.75,1236,68.25,1811,98.96,19,1.04,1830
1,NSW,125,Camden East,287,33.8,562,66.2,849,99.07,8,0.93,857
1,NSW,130,Camden Haven PPVC,1435,24.52,4417,75.48,5852,99.42,34,0.58,5886
1,NSW,125,Camden HUME PPVC,2931,23.89,9336,76.11,12267,99.32,84,0.68,12351
1,NSW,131,Camden MACARTHUR PPVC,328,22.62,1122,77.38,1450,98.91,16,1.09,1466
1,NSW,125,Camden South,561,33.84,1097,66.16,1658,99.04,16,0.96,1674
1,NSW,126,Cameron Park,741,36.31,1300,63.69,2041,98.84,24,1.16,2065
1,NSW,137,Cammeray,1475,67.54,709,32.46,2184,99.27,16,0.73,2200
1,NSW,137,Cammeray Central,184,69.17,82,30.83,266,99.25,2,0.75,268
1,NSW,137,Cammeray South,696,69.32,308,30.68,1004,98.92,11,1.08,1015
1,NSW,131,Campbelltown,809,48.33,865,51.67,1674,98.07,33,1.93,1707
1,NSW,131,Campbelltown East,544,33.09,1100,66.91,1644,97.8,37,2.2,1681
1,NSW,125,Campbelltown HUME PPVC,373,57.38,277,42.62,650,98.34,11,1.66,661
1,NSW,131,Campbelltown MACARTHUR PPVC,5207,31.02,11581,68.98,16788,98.85,195,1.15,16983
1,NSW,131,Campbelltown North,475,44.77,586,55.23,1061,98.15,20,1.85,1081
1,NSW,131,Campbelltown North East,235,40.52,345,59.48,580,97.81,13,2.19,593
1,NSW,149,Camperdown,660,84.83,118,15.17,778,99.49,4,0.51,782
1,NSW,121,Camperdown South (Grayndler),317,87.09,47,12.91,364,99.73,1,0.27,365
1,NSW,149,Camperdown South (Sydney),1200,88.11,162,11.89,1362,98.84,16,1.16,1378
1,NSW,251,Campsie,857,48.92,895,51.08,1752,97.82,39,2.18,1791
1,NSW,251,Campsie North,708,43.04,937,56.96,1645,98.03,33,1.97,1678
1,NSW,251,Campsie South,342,48.24,367,51.76,709,97.26,20,2.74,729
1,NSW,251,Campsie West,208,44.35,261,55.65,469,97.71,11,2.29,480
1,NSW,117,Candelo,204,48.92,213,51.08,417,98.58,6,1.42,423
1,NSW,138,Caniaba,110,29.26,266,70.74,376,98.95,4,1.05,380
1,NSW,119,Canley Heights,592,46.84,672,53.16,1264,97.91,27,2.09,1291
1,NSW,119,Canley Vale,734,46.51,844,53.49,1578,97.23,45,2.77,1623
1,NSW,109,Canobolas,81,45,99,55,180,99.45,1,0.55,181
1,NSW,109,Canowindra,215,19.82,870,80.18,1085,99,11,1,1096
1,NSW,121,Canterbury North (Grayndler),271,63.76,154,36.24,425,98.38,7,1.62,432
1,NSW,251,Canterbury North (Watson),554,63.17,323,36.83,877,98.76,11,1.24,888
1,NSW,104,Canterbury South,997,53.17,878,46.83,1875,98.27,33,1.73,1908
1,NSW,125,Canyonleigh,35,26.32,98,73.68,133,99.25,1,0.75,134
1,NSW,109,Capertee,28,19.31,117,80.69,145,99.32,1,0.68,146
1,NSW,117,Captains Flat,104,40.63,152,59.38,256,98.08,5,1.92,261
1,NSW,250,Caragabal,24,23.53,78,76.47,102,100,0,0,102
1,NSW,109,Carcoar,60,30.46,137,69.54,197,99.49,1,0.51,198
1,NSW,148,Cardiff,748,38.62,1189,61.38,1937,98.58,28,1.42,1965
1,NSW,136,Cardiff Heights (Newcastle),388,59.69,262,40.31,650,99.09,6,0.91,656
1,NSW,148,Cardiff Heights (Shortland),278,53.67,240,46.33,518,98.67,7,1.33,525
1,NSW,148,Cardiff North,460,49.09,477,50.91,937,98.74,12,1.26,949
1,NSW,148,Cardiff South,645,43.09,852,56.91,1497,98.88,17,1.12,1514
1,NSW,109,Cargo,58,21.01,218,78.99,276,99.64,1,0.36,277
1,NSW,112,Caringbah Central,629,43.08,831,56.92,1460,98.65,20,1.35,1480
1,NSW,112,Caringbah North,791,42.9,1053,57.1,1844,98.5,28,1.5,1872
1,NSW,112,Caringbah PPVC,2879,35.03,5340,64.97,8219,99.05,79,0.95,8298
1,NSW,112,Caringbah South,725,43.91,926,56.09,1651,99.04,16,0.96,1667
1,NSW,112,Caringbah West,568,47.49,628,52.51,1196,98.6,17,1.4,1213
1,NSW,105,Carlingford (Bennelong),403,44.14,510,55.86,913,98.6,13,1.4,926
1,NSW,140,Carlingford (Parramatta),540,44.52,673,55.48,1213,98.54,18,1.46,1231
1,NSW,105,Carlingford East,777,52.54,702,47.46,1479,98.01,30,1.99,1509
1,NSW,106,Carlingford Heights,548,41.48,773,58.52,1321,98.58,19,1.42,1340
1,NSW,140,Carlingford North,746,43.07,986,56.93,1732,98.19,32,1.81,1764
1,NSW,140,Carlingford South,164,51.9,152,48.1,316,98.75,4,1.25,320
1,NSW,104,Carlton,864,41.5,1218,58.5,2082,97.65,50,2.35,2132
1,NSW,103,Carlton South (Banks),455,44.22,574,55.78,1029,98.47,16,1.53,1045
1,NSW,104,Carlton South (Barton),338,45.99,397,54.01,735,97.35,20,2.65,755
1,NSW,112,Carlton South (Cook),230,33.72,452,66.28,682,98.7,9,1.3,691
1,NSW,103,Carlton West,504,40.1,753,59.9,1257,97.67,30,2.33,1287
1,NSW,153,Carnes Hill,669,37.61,1110,62.39,1779,98.18,33,1.82,1812
1,NSW,119,Carnes Hill FOWLER PPVC,190,35.92,339,64.08,529,99.06,5,0.94,534
1,NSW,153,Carnes Hill WERRIWA PPVC,10803,46.37,12492,53.63,23295,98.7,307,1.3,23602
1,NSW,135,Caroona,50,27.17,134,72.83,184,99.46,1,0.54,185
1,NSW,136,Carrington,985,66.11,505,33.89,1490,99.14,13,0.86,1503
1,NSW,139,Carroll,20,13.99,123,86.01,143,100,0,0,143
1,NSW,112,Carss Park,254,34.37,485,65.63,739,98.66,10,1.34,749
1,NSW,153,Cartwright,336,39.44,516,60.56,852,97.15,25,2.85,877
1,NSW,138,Casino,383,21.38,1408,78.62,1791,98.3,31,1.7,1822
1,NSW,138,Casino North,55,25,165,75,220,99.1,2,0.9,222
1,NSW,138,Casino PPVC,1240,16.79,6146,83.21,7386,99.26,55,0.74,7441
1,NSW,138,Casino South,53,21.2,197,78.8,250,98.04,5,1.96,255
1,NSW,138,Casino West,104,20.12,413,79.88,517,98.85,6,1.15,523
1,NSW,135,Cassilis,42,32.81,86,67.19,128,99.22,1,0.78,129
1,NSW,108,Castle Cove,832,54.38,698,45.62,1530,98.9,17,1.1,1547
1,NSW,134,Castle Hill,342,45.06,417,54.94,759,99.61,3,0.39,762
1,NSW,134,Castle Hill Central,1167,41.99,1612,58.01,2779,98.97,29,1.03,2808
1,NSW,134,Castle Hill East,897,46.48,1033,53.52,1930,97.77,44,2.23,1974
1,NSW,106,Castle Hill North (Berowra),258,45.18,313,54.82,571,95.97,24,4.03,595
1,NSW,134,Castle Hill North (Mitchell),911,40.26,1352,59.74,2263,98.78,28,1.22,2291
1,NSW,134,Castle Hill South West,698,46.32,809,53.68,1507,99.08,14,0.92,1521
1,NSW,134,Castle Hill West,1083,44.1,1373,55.9,2456,98.75,31,1.25,2487
1,NSW,137,Castlecrag,646,66.8,321,33.2,967,98.98,10,1.02,977
1,NSW,128,Castlereagh,150,17.48,708,82.52,858,99.31,6,0.69,864
1,NSW,145,Casuarina,547,50.55,535,49.45,1082,97.65,26,2.35,1108
1,NSW,145,Casuarina PPVC,2484,39.27,3841,60.73,6325,98.77,79,1.23,6404
1,NSW,153,Casula,707,37.49,1179,62.51,1886,96.97,59,3.03,1945
1,NSW,153,Casula South,699,37.82,1149,62.18,1848,97.93,39,2.07,1887
1,NSW,133,Cattai,26,19.7,106,80.3,132,99.25,1,0.75,133
1,NSW,148,Caves Beach,396,42.26,541,57.74,937,98.84,11,1.16,948
1,NSW,125,Cawdor,165,24.26,515,75.74,680,99.13,6,0.87,686
1,NSW,138,Cawongla,246,63.24,143,36.76,389,98.48,6,1.52,395
1,NSW,153,Cecil Hills,763,28.02,1960,71.98,2723,98.45,43,1.55,2766
1,NSW,153,Cecil Hills North,214,31.8,459,68.2,673,97.54,17,2.46,690
1,NSW,117,Central Tilba,119,61.34,75,38.66,194,98.98,2,1.02,196
1,NSW,126,Cessnock East,278,28.54,696,71.46,974,98.58,14,1.42,988
1,NSW,126,Cessnock HUNTER PPVC,2261,23.36,7417,76.64,9678,99.28,70,0.72,9748
1,NSW,126,Cessnock North,203,30.9,454,69.1,657,98.95,7,1.05,664
1,NSW,249,Cessnock PATERSON PPVC,104,30.06,242,69.94,346,97.46,9,2.54,355
1,NSW,126,Cessnock West,478,29.91,1120,70.09,1598,98.58,23,1.42,1621
1,NSW,148,Chain Valley Bay,232,31.78,498,68.22,730,98.65,10,1.35,740
1,NSW,148,Charlestown,793,54.5,662,45.5,1455,99.05,14,0.95,1469
1,NSW,148,Charlestown East,621,52.85,554,47.15,1175,98.33,20,1.67,1195
1,NSW,126,Charlestown HUNTER PPVC,218,41.84,303,58.16,521,98.86,6,1.14,527
1,NSW,136,Charlestown NEWCASTLE PPVC,1988,52.23,1818,47.77,3806,98.91,42,1.09,3848
1,NSW,148,Charlestown SHORTLAND PPVC,4452,40.4,6568,59.6,11020,99.18,91,0.82,11111
1,NSW,148,Charlestown South,634,49.07,658,50.93,1292,98.63,18,1.37,1310
1,NSW,115,Charmhaven,236,30.33,542,69.67,778,99.23,6,0.77,784
1,NSW,115,Charmhaven DOBELL PPVC,686,24.93,2066,75.07,2752,98.89,31,1.11,2783
1,NSW,148,Charmhaven SHORTLAND PPVC,712,22.52,2450,77.48,3162,99.03,31,0.97,3193
1,NSW,130,Chatham,154,22.55,529,77.45,683,99.27,5,0.73,688
1,NSW,108,Chatswood (Bradfield),566,46.43,653,53.57,1219,98.31,21,1.69,1240
1,NSW,137,Chatswood (North Sydney),471,49.06,489,50.94,960,98.26,17,1.74,977
1,NSW,105,Chatswood BENNELONG PPVC,65,45.14,79,54.86,144,97.96,3,2.04,147
1,NSW,108,Chatswood BRADFIELD PPVC,896,49.31,921,50.69,1817,99.13,16,0.87,1833
1,NSW,137,Chatswood East,377,53.48,328,46.52,705,99.02,7,0.98,712
1,NSW,132,Chatswood MACKELLAR PPVC,189,45.22,229,54.78,418,99.05,4,0.95,422
1,NSW,137,Chatswood NORTH SYDNEY PPVC,680,46.64,778,53.36,1458,98.78,18,1.22,1476
1,NSW,137,Chatswood South,598,64.09,335,35.91,933,99.15,8,0.85,941
1,NSW,151,Chatswood WARRINGAH PPVC,214,52.97,190,47.03,404,99.26,3,0.74,407
1,NSW,108,Chatswood West (Bradfield),358,54.24,302,45.76,660,98.36,11,1.64,671
1,NSW,137,Chatswood West (North Sydney),604,53.17,532,46.83,1136,98.87,13,1.13,1149
1,NSW,138,Chatsworth Island,65,34.21,125,65.79,190,99.48,1,0.52,191
1,NSW,106,Cheltenham,674,60.78,435,39.22,1109,99.11,10,0.89,1119
1,NSW,106,Cherrybrook,860,47.12,965,52.88,1825,99.24,14,0.76,1839
1,NSW,106,Cherrybrook BEROWRA PPVC,4312,40.45,6347,59.55,10659,99.43,61,0.57,10720
1,NSW,106,Cherrybrook Central,827,51.49,779,48.51,1606,99.01,16,0.99,1622
1,NSW,134,Cherrybrook MITCHELL PPVC,910,51.01,874,48.99,1784,99.06,17,0.94,1801
1,NSW,106,Cherrybrook North,784,53.55,680,46.45,1464,98.65,20,1.35,1484
1,NSW,106,Cherrybrook South,775,56.24,603,43.76,1378,99.07,13,0.93,1391
1,NSW,107,Chester Hill,577,39.47,885,60.53,1462,95.43,70,4.57,1532
1,NSW,107,Chester Hill Central,490,35.43,893,64.57,1383,97.12,41,2.88,1424
1,NSW,107,Chester Hill North,654,36.15,1155,63.85,1809,96.84,59,3.16,1868
1,NSW,107,Chester Hill North East,236,42.14,324,57.86,560,95.4,27,4.6,587
1,NSW,127,Chifley,697,51.55,655,48.45,1352,98.11,26,1.89,1378
1,NSW,145,Chillingham,96,41.56,135,58.44,231,99.57,1,0.43,232
1,NSW,145,Chinderah,295,47.73,323,52.27,618,98.25,11,1.75,629
1,NSW,119,Chipping Norton,650,31.89,1388,68.11,2038,98.26,36,1.74,2074
1,NSW,144,Chiswick,551,48.89,576,51.11,1127,99.38,7,0.62,1134
1,NSW,115,Chittaway Bay,757,38,1235,62,1992,98.57,29,1.43,2021
1,NSW,115,Chittaway Point,125,33.51,248,66.49,373,98.16,7,1.84,380
1,NSW,251,Chullora,362,31.15,800,68.85,1162,96.59,41,3.41,1203
1,NSW,117,City EDEN-MONARO PPVC,279,58.37,199,41.63,478,98.76,6,1.24,484
1,NSW,128,Claremont Meadows,838,35.22,1541,64.78,2379,98.55,35,1.45,2414
1,NSW,130,Clarence Town,325,24.94,978,75.06,1303,98.94,14,1.06,1317
1,NSW,131,Claymore,191,35.5,347,64.5,538,96.59,19,3.41,557
1,NSW,104,Clemton Park,762,39.34,1175,60.66,1937,97.73,45,2.27,1982
1,NSW,104,Clemton Park West,224,38.82,353,61.18,577,98.3,10,1.7,587
1,NSW,138,Clovass,48,18.97,205,81.03,253,98.83,3,1.17,256
1,NSW,152,Clovelly,689,76.3,214,23.7,903,95.15,46,4.85,949
1,NSW,127,Clovelly Beach (Kingsford Smith),443,77.04,132,22.96,575,98.8,7,1.2,582
1,NSW,152,Clovelly Beach (Wentworth),454,77.74,130,22.26,584,98.48,9,1.52,593
1,NSW,127,Clovelly North (Kingsford Smith),159,71.3,64,28.7,223,99.11,2,0.89,225
1,NSW,152,Clovelly North (Wentworth),736,71.25,297,28.75,1033,99.14,9,0.86,1042
1,NSW,138,Clunes,247,69.19,110,30.81,357,98.62,5,1.38,362
1,NSW,126,Coal Point,418,46.6,479,53.4,897,98.9,10,1.1,907
1,NSW,139,Cobar,131,21.55,477,78.45,608,98.54,9,1.46,617
1,NSW,139,Cobar PPVC,161,12.07,1173,87.93,1334,99.63,5,0.37,1339
1,NSW,117,Cobargo,280,43.08,370,56.92,650,99.09,6,0.91,656
1,NSW,125,Cobbitty,301,25.29,889,74.71,1190,98.84,14,1.16,1204
1,NSW,118,Cobram FARRER PPVC,235,19.71,957,80.29,1192,99,12,1,1204
1,NSW,113,Coffs Harbour,449,39.28,694,60.72,1143,98.62,16,1.38,1159
1,NSW,113,Coffs Harbour Central,734,45.53,878,54.47,1612,98.05,32,1.95,1644
1,NSW,113,Coffs Harbour COWPER PPVC,4842,31.23,10662,68.77,15504,99.4,94,0.6,15598
1,NSW,113,Coffs Harbour East,615,49,640,51,1255,98.35,21,1.65,1276
1,NSW,113,Coffs Harbour North,97,47.78,106,52.22,203,98.54,3,1.46,206
1,NSW,138,Coffs Harbour PAGE PPVC,1528,34.82,2860,65.18,4388,98.98,45,1.02,4433
1,NSW,113,Coffs Harbour South,552,37.02,939,62.98,1491,98.42,24,1.58,1515
1,NSW,113,Coffs Harbour West,695,37.25,1171,62.75,1866,97.59,46,2.41,1912
1,NSW,118,Coleambally,66,12.79,450,87.21,516,98.66,7,1.34,523
1,NSW,114,Coledale,663,68.63,303,31.37,966,99.38,6,0.62,972
1,NSW,139,Collarenebri,73,28.19,186,71.81,259,97.37,7,2.63,266
1,NSW,132,Collaroy,759,55.77,602,44.23,1361,98.77,17,1.23,1378
1,NSW,132,Collaroy Plateau,969,52.21,887,47.79,1856,99.15,16,0.85,1872
1,NSW,132,Collaroy Plateau North,116,53.7,100,46.3,216,99.54,1,0.46,217
1,NSW,125,Collector,64,35.75,115,64.25,179,98.35,3,1.65,182
1,NSW,250,Collingullie,18,10.71,150,89.29,168,100,0,0,168
1,NSW,133,Colo Heights,46,27.38,122,72.62,168,100,0,0,168
1,NSW,125,Colo Vale,243,32.44,506,67.56,749,99.21,6,0.79,755
1,NSW,128,Colyton,548,29.53,1308,70.47,1856,97.63,45,2.37,1901
1,NSW,128,Colyton West,207,35.32,379,64.68,586,98.82,7,1.18,593
1,NSW,130,Comboyne,44,17.81,203,82.19,247,98.8,3,1.2,250
1,NSW,124,Como West,1146,58.17,824,41.83,1970,98.85,23,1.15,1993
1,NSW,144,Concord,254,45.28,307,54.72,561,98.25,10,1.75,571
1,NSW,144,Concord City,539,41.24,768,58.76,1307,99.32,9,0.68,1316
1,NSW,144,Concord East,693,43.26,909,56.74,1602,98.34,27,1.66,1629
1,NSW,144,Concord North,672,51.34,637,48.66,1309,98.72,17,1.28,1326
1,NSW,144,Concord REID PPVC,6251,40.89,9035,59.11,15286,99.21,122,0.79,15408
1,NSW,251,Concord WATSON PPVC,182,38.32,293,61.68,475,98.55,7,1.45,482
1,NSW,144,Concord West,513,47.99,556,52.01,1069,99.53,5,0.47,1074
1,NSW,107,Condell Park,532,26.48,1477,73.52,2009,96.49,73,3.51,2082
1,NSW,107,Condell Park North,226,25.71,653,74.29,879,98.32,15,1.68,894
1,NSW,107,Condell Park South,418,31.88,893,68.12,1311,95.69,59,4.31,1370
1,NSW,107,Condell Park West,253,29.45,606,70.55,859,95.13,44,4.87,903
1,NSW,139,Condobolin,333,24.06,1051,75.94,1384,99.14,12,0.86,1396
1,NSW,114,Coniston,661,49.81,666,50.19,1327,97.5,34,2.5,1361
1,NSW,103,Connells Point (Banks),542,32.53,1124,67.47,1666,98.35,28,1.65,1694
1,NSW,112,Connells Point (Cook),256,28.57,640,71.43,896,99.22,7,0.78,903
1,NSW,109,Cooerwull,344,33.63,679,66.37,1023,98.65,14,1.35,1037
1,NSW,127,Coogee,1055,75.25,347,24.75,1402,99.08,13,0.92,1415
1,NSW,127,Coogee Beach,999,72.81,373,27.19,1372,98.63,19,1.37,1391
1,NSW,127,Coogee Central,636,76.44,196,23.56,832,99.05,8,0.95,840
1,NSW,127,Coogee East,239,60.35,157,39.65,396,99.25,3,0.75,399
1,NSW,127,Coogee South,955,58.66,673,41.34,1628,99.15,14,0.85,1642
1,NSW,136,Cooks Hill,651,67.74,310,32.26,961,98.06,19,1.94,980
1,NSW,136,Cooks Hill South,994,68.5,457,31.5,1451,98.44,23,1.56,1474
1,NSW,250,Coolac,27,14.92,154,85.08,181,98.37,3,1.63,184
1,NSW,139,Coolah,101,15.91,534,84.09,635,98.91,7,1.09,642
1,NSW,250,Coolamon,247,22.56,848,77.44,1095,99.36,7,0.64,1102
1,NSW,130,Coolongolook,64,23.79,205,76.21,269,99.26,2,0.74,271
1,NSW,117,Cooma,292,32.99,593,67.01,885,99.22,7,0.78,892
1,NSW,117,Cooma North,244,40.4,360,59.6,604,99.34,4,0.66,608
1,NSW,117,Cooma PPVC,1102,25.25,3262,74.75,4364,99.11,39,0.89,4403
1,NSW,130,Coomba Park,104,25.06,311,74.94,415,98.81,5,1.19,420
1,NSW,139,Coonabarabran,435,24.01,1377,75.99,1812,98.69,24,1.31,1836
1,NSW,139,Coonamble,216,32.1,457,67.9,673,97.96,14,2.04,687
1,NSW,139,Coonamble PPVC,202,20.55,781,79.45,983,99.59,4,0.41,987
1,NSW,130,Coopernook,90,24.19,282,75.81,372,98.67,5,1.33,377
1,NSW,145,Coorabell,211,68.95,95,31.05,306,99.35,2,0.65,308
1,NSW,126,Cooranbong,379,30.71,855,69.29,1234,98.56,18,1.44,1252
1,NSW,126,Cooranbong PPVC,1806,25.43,5297,74.57,7103,98.93,77,1.07,7180
1,NSW,250,Cootamundra,180,26.71,494,73.29,674,99.41,4,0.59,678
1,NSW,250,Cootamundra PPVC,743,21.69,2682,78.31,3425,99.45,19,0.55,3444
1,NSW,250,Cootamundra West,117,19.8,474,80.2,591,98.66,8,1.34,599
1,NSW,146,Copacabana,678,56.17,529,43.83,1207,99.02,12,0.98,1219
1,NSW,138,Copmanhurst,51,19.62,209,80.38,260,99.24,2,0.76,262
1,NSW,138,Coraki,183,23.31,602,76.69,785,98,16,2,801
1,NSW,138,Coramba,78,32.23,164,67.77,242,97.98,5,2.02,247
1,NSW,114,Cordeaux Heights,685,51.2,653,48.8,1338,98.38,22,1.62,1360
1,NSW,138,Corindi,343,38.41,550,61.59,893,98.24,16,1.76,909
1,NSW,249,Corlette,305,33.89,595,66.11,900,99.34,6,0.66,906
1,NSW,118,Corowa,198,24.75,602,75.25,800,97.92,17,2.08,817
1,NSW,118,Corowa PPVC,735,22.36,2552,77.64,3287,99.19,27,0.81,3314
1,NSW,118,Corowa South,56,25.81,161,74.19,217,99.09,2,0.91,219
1,NSW,114,Corrimal,998,54.3,840,45.7,1838,98.18,34,1.82,1872
1,NSW,114,Corrimal East,922,54.46,771,45.54,1693,97.97,35,2.03,1728
1,NSW,114,Corrimal PPVC,9086,48.03,9832,51.97,18918,99.01,190,0.99,19108
1,NSW,138,Coutts Crossing,129,19.79,523,80.21,652,98.34,11,1.66,663
1,NSW,106,Cowan,226,56.5,174,43.5,400,98.04,8,1.96,408
1,NSW,138,Cowper,67,29.91,157,70.09,224,99.12,2,0.88,226
1,NSW,250,Cowra,239,24.31,744,75.69,983,98.69,13,1.31,996
1,NSW,250,Cowra North,155,25.58,451,74.42,606,98.22,11,1.78,617
1,NSW,250,Cowra PPVC,819,18.12,3702,81.88,4521,99.21,36,0.79,4557
1,NSW,250,Cowra West,181,22.63,619,77.38,800,98.89,9,1.11,809
1,NSW,145,Crabbes Creek,184,53.64,159,46.36,343,97.72,8,2.28,351
1,NSW,128,Cranebrook,605,29.27,1462,70.73,2067,98.43,33,1.57,2100
1,NSW,128,Cranebrook Central,276,31.12,611,68.88,887,99,9,1,896
1,NSW,128,Cranebrook North,195,35.2,359,64.8,554,98.93,6,1.07,560
1,NSW,128,Cranebrook South,557,32.25,1170,67.75,1727,98.63,24,1.37,1751
1,NSW,137,Cremorne (North Sydney),940,63.47,541,36.53,1481,98.8,18,1.2,1499
1,NSW,151,Cremorne (Warringah),263,65.26,140,34.74,403,100,0,0,403
1,NSW,151,Cremorne South,722,68.89,326,31.11,1048,99.71,3,0.29,1051
1,NSW,113,Crescent Head,273,50.74,265,49.26,538,98.53,8,1.47,546
1,NSW,134,Crestwood,491,52.29,448,47.71,939,98.95,10,1.05,949
1,NSW,134,Crestwood Central,1040,44.12,1317,55.88,2357,99.2,19,0.8,2376
1,NSW,150,Cringila,280,33.18,564,66.82,844,95.69,38,4.31,882
1,NSW,132,Cromer,818,51.9,758,48.1,1576,98.75,20,1.25,1596
1,NSW,132,Cromer East,718,52.52,649,47.48,1367,98.91,15,1.09,1382
1,NSW,112,Cronulla,539,42.61,726,57.39,1265,98.52,19,1.48,1284
1,NSW,112,Cronulla Central,666,49.93,668,50.07,1334,98.96,14,1.04,1348
1,NSW,112,Cronulla PPVC,2749,38.27,4435,61.73,7184,98.84,84,1.16,7268
1,NSW,112,Cronulla South,721,46.52,829,53.48,1550,99.17,13,0.83,1563
1,NSW,125,Crookwell,333,25.11,993,74.89,1326,99.1,12,0.9,1338
1,NSW,137,Crows Nest,917,67.43,443,32.57,1360,98.55,20,1.45,1380
1,NSW,108,Crows Nest BRADFIELD PPVC,231,55.26,187,44.74,418,99.29,3,0.71,421
1,NSW,137,Crows Nest East,635,67.34,308,32.66,943,98.85,11,1.15,954
1,NSW,137,Crows Nest NORTH SYDNEY PPVC,6656,60.69,4311,39.31,10967,99.17,92,0.83,11059
1,NSW,151,Crows Nest WARRINGAH PPVC,298,60.69,193,39.31,491,100,0,0,491
1,NSW,144,Croydon (Reid),460,52.21,421,47.79,881,99.44,5,0.56,886
1,NSW,251,Croydon (Watson),103,39.77,156,60.23,259,98.48,4,1.52,263
1,NSW,144,Croydon North,736,63.45,424,36.55,1160,99.32,8,0.68,1168
1,NSW,251,Croydon Park,1176,49.6,1195,50.4,2371,98.02,48,1.98,2419
1,NSW,144,Croydon South (Reid),114,58.46,81,41.54,195,100,0,0,195
1,NSW,251,Croydon South (Watson),121,60.2,80,39.8,201,98.53,3,1.47,204
1,NSW,145,Crystal Creek,98,29.34,236,70.66,334,99.7,1,0.3,335
1,NSW,109,Cudal,61,18.37,271,81.63,332,99.1,3,0.9,335
1,NSW,120,Cudmirrah,205,35.53,372,64.47,577,94.75,32,5.25,609
1,NSW,120,Culburra,501,42.17,687,57.83,1188,98.59,17,1.41,1205
1,NSW,118,Culcairn,159,22.84,537,77.16,696,98.72,9,1.28,705
1,NSW,109,Cullen Bullen,21,14.69,122,85.31,143,100,0,0,143
1,NSW,139,Cumborah,25,16.89,123,83.11,148,100,0,0,148
1,NSW,109,Cumnock,42,17.72,195,82.28,237,99.58,1,0.42,238
1,NSW,130,Cundletown,169,19.86,682,80.14,851,99.3,6,0.7,857
1,NSW,139,Curban,15,11.81,112,88.19,127,98.45,2,1.55,129
1,NSW,151,Curl Curl,1080,63.53,620,36.47,1700,98.61,24,1.39,1724
1,NSW,139,Curlewis,54,17.25,259,82.75,313,99.05,3,0.95,316
1,NSW,135,Currabubula,65,24.9,196,75.1,261,98.86,3,1.14,264
1,NSW,131,Currans Hill,526,30.39,1205,69.61,1731,98.63,24,1.37,1755
1,NSW,120,Currarong,108,46.55,124,53.45,232,98.72,3,1.28,235
1,NSW,127,Daceyville,647,53.56,561,46.44,1208,98.13,23,1.87,1231
1,NSW,117,Dalgety,41,38.68,65,61.32,106,100,0,0,106
1,NSW,117,Dalmeny,178,42.58,240,57.42,418,99.29,3,0.71,421
1,NSW,125,Dalton,54,27.84,140,72.16,194,98.48,3,1.52,197
1,NSW,139,Dangar Village,52,21.76,187,78.24,239,99.17,2,0.83,241
1,NSW,135,Dangarsleigh,38,26.39,106,73.61,144,100,0,0,144
1,NSW,150,Dapto,985,37.17,1665,62.83,2650,98.59,38,1.41,2688
1,NSW,114,Dapto CUNNINGHAM PPVC,1140,37.54,1897,62.46,3037,98.93,33,1.07,3070
1,NSW,150,Dapto East,228,36.42,398,63.58,626,98.74,8,1.26,634
1,NSW,150,Dapto South,366,38.45,586,61.55,952,98.14,18,1.86,970
1,NSW,150,Dapto WHITLAM PPVC,4434,31.66,9573,68.34,14007,98.83,166,1.17,14173
1,NSW,118,Dareton,74,18.32,330,81.68,404,98.54,6,1.46,410
1,NSW,149,Darling Harbour,371,60.72,240,39.28,611,98.87,7,1.13,618
1,NSW,152,Darling Point,678,53.43,591,46.57,1269,99.22,10,0.78,1279
1,NSW,149,Darlinghurst East (Sydney),523,80.46,127,19.54,650,99.54,3,0.46,653
1,NSW,152,Darlinghurst East (Wentworth),249,73.89,88,26.11,337,100,0,0,337
1,NSW,149,Darlington,1020,83.88,196,16.12,1216,99.43,7,0.57,1223
1,NSW,149,Darlington Central,530,85.07,93,14.93,623,99.36,4,0.64,627
1,NSW,118,Darlington Point,156,25.96,445,74.04,601,98.69,8,1.31,609
1,NSW,132,Davidson,419,56.78,319,43.22,738,99.46,4,0.54,742
1,NSW,146,Davistown,536,47.22,599,52.78,1135,99.04,11,0.96,1146
1,NSW,111,Dean Park,956,38.49,1528,61.51,2484,97.83,55,2.17,2539
1,NSW,132,Dee Why,1135,54.59,944,45.41,2079,98.34,35,1.66,2114
1,NSW,132,Dee Why Central (Mackellar),198,51.83,184,48.17,382,93.4,27,6.6,409
1,NSW,151,Dee Why Central (Warringah),304,63.07,178,36.93,482,98.37,8,1.63,490
1,NSW,132,Dee Why East (Mackellar),870,53.54,755,46.46,1625,98.31,28,1.69,1653
1,NSW,151,Dee Why East (Warringah),554,57.35,412,42.65,966,98.37,16,1.63,982
1,NSW,132,Dee Why North,290,58.94,202,41.06,492,98.99,5,1.01,497
1,NSW,135,Deepwater,37,14.4,220,85.6,257,98.09,5,1.91,262
1,NSW,117,Delegate,205,83.67,40,16.33,245,99.59,1,0.41,246
1,NSW,135,Delungra,20,8.7,210,91.3,230,99.14,2,0.86,232
1,NSW,153,Denham Court,49,26.06,139,73.94,188,98.95,2,1.05,190
1,NSW,131,Denham Court West,1111,41.92,1539,58.08,2650,98.29,46,1.71,2696
1,NSW,118,Deniliquin,254,25.12,757,74.88,1011,99.21,8,0.79,1019
1,NSW,118,Deniliquin North,60,17.05,292,82.95,352,99.15,3,0.85,355
1,NSW,118,Deniliquin PPVC,625,17.78,2891,82.22,3516,99.21,28,0.79,3544
1,NSW,118,Deniliquin West,92,22.6,315,77.4,407,99.03,4,0.97,411
1,NSW,105,Denistone,434,49.89,436,50.11,870,99.54,4,0.46,874
1,NSW,105,Denistone East,932,47.38,1035,52.62,1967,98.74,25,1.26,1992
1,NSW,105,Denistone South,391,50.98,376,49.02,767,98.84,9,1.16,776
1,NSW,105,Denistone West,367,51.4,347,48.6,714,98.89,8,1.11,722
1,NSW,126,Denman,190,20.23,749,79.77,939,98.84,11,1.16,950
1,NSW,111,Dharruk,379,38.13,615,61.87,994,95.03,52,4.97,1046
1,NSW,130,Diamond Beach,198,38.22,320,61.78,518,98.11,10,1.89,528
1,NSW,121,Dobroyd Point,716,61.04,457,38.96,1173,98.82,14,1.18,1187
1,NSW,111,Doonside,999,45.43,1200,54.57,2199,98.57,32,1.43,2231
1,NSW,111,Doonside Central,338,42.25,462,57.75,800,97.92,17,2.08,817
1,NSW,111,Doonside North,1073,43.53,1392,56.47,2465,98.92,27,1.08,2492
1,NSW,111,Doonside South,508,38.02,828,61.98,1336,98.02,27,1.98,1363
1,NSW,126,Dora Creek,324,31.98,689,68.02,1013,98.73,13,1.27,1026
1,NSW,113,Dorrigo,457,39.13,711,60.87,1168,98.32,20,1.68,1188
1,NSW,152,Double Bay,1155,56.51,889,43.49,2044,99.03,20,0.97,2064
1,NSW,152,Double Bay East,275,51.89,255,48.11,530,98.51,8,1.49,538
1,NSW,125,Douglas Park,176,25.04,527,74.96,703,98.74,9,1.26,712
1,NSW,152,Dover Heights,595,49.21,614,50.79,1209,98.05,24,1.95,1233
1,NSW,135,Drake,68,35.6,123,64.4,191,97.95,4,2.05,195
1,NSW,144,Drummoyne,1255,60.31,826,39.69,2081,99.05,20,0.95,2101
1,NSW,144,Drummoyne East,380,58.91,265,41.09,645,99.69,2,0.31,647
1,NSW,144,Drummoyne North,861,54.22,727,45.78,1588,98.27,28,1.73,1616
1,NSW,139,Dubbo,363,34.84,679,65.16,1042,98.96,11,1.04,1053
1,NSW,139,Dubbo Blue Ridge,99,29.12,241,70.88,340,99.42,2,0.58,342
1,NSW,109,Dubbo CALARE PPVC,168,17.59,787,82.41,955,99.27,7,0.73,962
1,NSW,139,Dubbo East,446,29.19,1082,70.81,1528,98.96,16,1.04,1544
1,NSW,139,Dubbo Grove,260,31.67,561,68.33,821,99.27,6,0.73,827
1,NSW,139,Dubbo North,235,20.09,935,79.91,1170,97.18,34,2.82,1204
1,NSW,139,Dubbo PARKES PPVC,3481,20.68,13355,79.32,16836,99.08,156,0.92,16992
1,NSW,139,Dubbo South,549,35.84,983,64.16,1532,98.77,19,1.23,1551
1,NSW,139,Dubbo West,475,29.52,1134,70.48,1609,97.34,44,2.66,1653
1,NSW,148,Dudley,630,60.06,419,39.94,1049,98.96,11,1.04,1060
1,NSW,121,Dulwich Hill,1108,71.76,436,28.24,1544,98.78,19,1.22,1563
1,NSW,121,Dulwich Hill South,161,71.56,64,28.44,225,99.12,2,0.88,227
1,NSW,121,Dulwich Hill West,771,77.1,229,22.9,1000,99.11,9,0.89,1009
1,NSW,130,Dunbogan,94,31.23,207,68.77,301,99.67,1,0.33,302
1,NSW,140,Dundas,852,45.17,1034,54.83,1886,98.23,34,1.77,1920
1,NSW,140,Dundas Valley,340,42.82,454,57.18,794,98.88,9,1.12,803
1,NSW,140,Dundas Valley South,647,47.09,727,52.91,1374,98.64,19,1.36,1393
1,NSW,138,Dundurrabin,83,48.54,88,51.46,171,100,0,0,171
1,NSW,139,Dunedoo,93,16.09,485,83.91,578,98.8,7,1.2,585
1,NSW,145,Dungay,107,36.03,190,63.97,297,98.67,4,1.33,301
1,NSW,130,Dungog,526,32.59,1088,67.41,1614,99.38,10,0.62,1624
1,NSW,135,Dungowan,36,15.32,199,84.68,235,99.58,1,0.42,236
1,NSW,138,Dunoon,287,63.36,166,36.64,453,98.91,5,1.09,458
1,NSW,106,Dural,453,33.11,915,66.89,1368,98.99,14,1.01,1382
1,NSW,135,Duri,35,16.28,180,83.72,215,100,0,0,215
1,NSW,145,Durrumbul,99,70.21,42,29.79,141,98.6,2,1.4,143
1,NSW,131,Eagle Vale,672,36.5,1169,63.5,1841,98.13,35,1.87,1876
1,NSW,104,Earlwood,395,36.17,697,63.83,1092,98.64,15,1.36,1107
1,NSW,104,Earlwood Central,362,42.29,494,57.71,856,98.73,11,1.27,867
1,NSW,104,Earlwood South,856,41.13,1225,58.87,2081,98.11,40,1.89,2121
1,NSW,103,East Hills,427,40.28,633,59.72,1060,98.79,13,1.21,1073
1,NSW,249,East Maitland,422,48.79,443,51.21,865,98.3,15,1.7,880
1,NSW,249,East Maitland Central,294,45.09,358,54.91,652,98.34,11,1.66,663
1,NSW,126,East Maitland HUNTER PPVC,97,26.36,271,73.64,368,98.92,4,1.08,372
1,NSW,130,East Maitland LYNE PPVC,645,26.76,1765,73.24,2410,99.14,21,0.86,2431
1,NSW,249,East Maitland PATERSON PPVC,4391,29.01,10747,70.99,15138,98.87,173,1.13,15311
1,NSW,249,East Maitland South,1064,36.87,1822,63.13,2886,98.57,42,1.43,2928
1,NSW,105,East Ryde,1032,50.99,992,49.01,2024,98.35,34,1.65,2058
1,NSW,105,East Ryde Central,272,45.33,328,54.67,600,99.17,5,0.83,605
1,NSW,105,East Ryde Heights,215,54.99,176,45.01,391,98.49,6,1.51,397
1,NSW,127,Eastlakes,280,42.62,377,57.38,657,99.24,5,0.76,662
1,NSW,127,Eastlakes East,495,52.66,445,47.34,940,98.64,13,1.36,953
1,NSW,127,Eastlakes KINGSFORD SMITH PPVC,2769,45.19,3359,54.81,6128,98.92,67,1.08,6195
1,NSW,149,Eastlakes SYDNEY PPVC,1069,51.97,988,48.03,2057,99.47,11,0.53,2068
1,NSW,105,Eastwood,643,43.07,850,56.93,1493,99.14,13,0.86,1506
1,NSW,105,Eastwood BENNELONG PPVC,3268,41.65,4579,58.35,7847,98.9,87,1.1,7934
1,NSW,105,Eastwood Heights,848,52.28,774,47.72,1622,98.84,19,1.16,1641
1,NSW,140,Eastwood PARRAMATTA PPVC,796,37.02,1354,62.98,2150,98.9,24,1.1,2174
1,NSW,105,Eastwood West,305,46.14,356,53.86,661,98.95,7,1.05,668
1,NSW,103,EAV Banks PPVC,0,0,0,0,0,0,0,0,0
1,NSW,104,EAV Barton PPVC,0,0,0,0,0,0,0,0,0
1,NSW,105,EAV Bennelong PPVC,0,0,0,0,0,0,0,0,0
1,NSW,106,EAV Berowra PPVC,0,0,0,0,0,0,0,0,0
1,NSW,107,EAV Blaxland PPVC,0,0,0,0,0,0,0,0,0
1,NSW,108,EAV Bradfield PPVC,0,0,0,0,0,0,0,0,0
1,NSW,109,EAV Calare PPVC,0,0,0,0,0,0,0,0,0
1,NSW,111,EAV Chifley PPVC,0,0,0,0,0,0,0,0,0
1,NSW,112,EAV Cook PPVC,0,0,0,0,0,0,0,0,0
1,NSW,113,EAV Cowper PPVC,0,0,0,0,0,0,0,0,0
1,NSW,114,EAV Cunningham PPVC,0,0,0,0,0,0,0,0,0
1,NSW,115,EAV Dobell PPVC,0,0,0,0,0,0,0,0,0
1,NSW,117,EAV Eden-Monaro PPVC,0,0,0,0,0,0,0,0,0
1,NSW,118,EAV Farrer PPVC,0,0,0,0,0,0,0,0,0
1,NSW,119,EAV Fowler PPVC,0,0,0,0,0,0,0,0,0
1,NSW,120,EAV Gilmore PPVC,0,0,0,0,0,0,0,0,0
1,NSW,121,EAV Grayndler PPVC,0,0,0,0,0,0,0,0,0
1,NSW,122,EAV Greenway PPVC,0,0,0,0,0,0,0,0,0
1,NSW,124,EAV Hughes PPVC,0,0,0,0,0,0,0,0,0
1,NSW,125,EAV Hume PPVC,0,0,0,0,0,0,0,0,0
1,NSW,126,EAV Hunter PPVC,0,0,0,0,0,0,0,0,0
1,NSW,127,EAV Kingsford Smith PPVC,0,0,0,0,0,0,0,0,0
1,NSW,128,EAV Lindsay PPVC,0,0,0,0,0,0,0,0,0
1,NSW,130,EAV Lyne PPVC,0,0,0,0,0,0,0,0,0
1,NSW,131,EAV Macarthur PPVC,0,0,0,0,0,0,0,0,0
1,NSW,132,EAV Mackellar PPVC,0,0,0,0,0,0,0,0,0
1,NSW,133,EAV Macquarie PPVC,0,0,0,0,0,0,0,0,0
1,NSW,315,EAV McMahon PPVC,0,0,0,0,0,0,0,0,0
1,NSW,134,EAV Mitchell PPVC,0,0,0,0,0,0,0,0,0
1,NSW,135,EAV New England PPVC,0,0,0,0,0,0,0,0,0
1,NSW,136,EAV Newcastle PPVC,0,0,0,0,0,0,0,0,0
1,NSW,137,EAV North Sydney PPVC,0,0,0,0,0,0,0,0,0
1,NSW,138,EAV Page PPVC,0,0,0,0,0,0,0,0,0
1,NSW,139,EAV Parkes PPVC,0,0,0,0,0,0,0,0,0
1,NSW,140,EAV Parramatta PPVC,0,0,0,0,0,0,0,0,0
1,NSW,249,EAV Paterson PPVC,0,0,0,0,0,0,0,0,0
1,NSW,144,EAV Reid PPVC,0,0,0,0,0,0,0,0,0
1,NSW,145,EAV Richmond PPVC,0,0,0,0,0,0,0,0,0
1,NSW,250,EAV Riverina PPVC,0,0,0,0,0,0,0,0,0
1,NSW,146,EAV Robertson PPVC,0,0,0,0,0,0,0,0,0
1,NSW,148,EAV Shortland PPVC,0,0,0,0,0,0,0,0,0
1,NSW,149,EAV Sydney PPVC,0,0,0,0,0,0,0,0,0
1,NSW,151,EAV Warringah PPVC,0,0,0,0,0,0,0,0,0
1,NSW,251,EAV Watson PPVC,0,0,0,0,0,0,0,0,0
1,NSW,152,EAV Wentworth PPVC,0,0,0,0,0,0,0,0,0
1,NSW,153,EAV Werriwa PPVC,0,0,0,0,0,0,0,0,0
1,NSW,150,EAV Whitlam PPVC,0,0,0,0,0,0,0,0,0
1,NSW,133,Ebenezer,154,21.24,571,78.76,725,99.59,3,0.41,728
1,NSW,135,Ebor,19,27.54,50,72.46,69,97.18,2,2.82,71
1,NSW,118,Echuca FARRER PPVC,666,19.44,2760,80.56,3426,99.39,21,0.61,3447
1,NSW,117,Eden,310,32.09,656,67.91,966,98.77,12,1.23,978
1,NSW,117,Eden Central,153,35.75,275,64.25,428,98.39,7,1.61,435
1,NSW,119,Edensor Park,495,33.31,991,66.69,1486,96.43,55,3.57,1541
1,NSW,119,Edensor Park North,472,36,839,64,1311,98.28,23,1.72,1334
1,NSW,152,Edgecliff,180,63.83,102,36.17,282,99.65,1,0.35,283
1,NSW,126,Edgeworth,541,33.58,1070,66.42,1611,98.11,31,1.89,1642
1,NSW,126,Edgeworth Heights,323,34.55,612,65.45,935,98.42,15,1.58,950
1,NSW,126,Edgeworth HUNTER PPVC,1929,28.43,4857,71.57,6786,99.04,66,0.96,6852
1,NSW,148,Edgeworth SHORTLAND PPVC,275,30.29,633,69.71,908,99.02,9,0.98,917
1,NSW,153,Edmondson Park,1075,43.72,1384,56.28,2459,98.28,43,1.72,2502
1,NSW,109,Eglinton,353,31.57,765,68.43,1118,98.94,12,1.06,1130
1,NSW,130,Elands,52,54.17,44,45.83,96,100,0,0,96
1,NSW,132,Elanora Heights,743,61.66,462,38.34,1205,98.85,14,1.15,1219
1,NSW,126,Elderslie,106,25.67,307,74.33,413,99.28,3,0.72,416
1,NSW,125,Elderslie Central,489,34.63,923,65.37,1412,98.6,20,1.4,1432
1,NSW,148,Eleebana,1078,47.43,1195,52.57,2273,98.87,26,1.13,2299
1,NSW,126,Elermore Vale (Hunter),89,43.2,117,56.8,206,98.1,4,1.9,210
1,NSW,136,Elermore Vale (Newcastle),712,45.21,863,54.79,1575,98.75,20,1.25,1595
1,NSW,149,Elizabeth Bay (Sydney),108,73.47,39,26.53,147,98,3,2,150
1,NSW,152,Elizabeth Bay (Wentworth),431,76.55,132,23.45,563,99.65,2,0.35,565
1,NSW,126,Ellalong,235,28.73,583,71.27,818,99.76,2,0.24,820
1,NSW,138,Eltham,127,49.22,131,50.78,258,97.73,6,2.27,264
1,NSW,113,Emerald Downs,304,34.62,574,65.38,878,98.87,10,1.13,888
1,NSW,131,Emerald Hills,441,42.49,597,57.51,1038,98.76,13,1.24,1051
1,NSW,135,Emmaville,37,20.44,144,79.56,181,98.37,3,1.63,184
1,NSW,146,Empire Bay,723,47.29,806,52.71,1529,98.58,22,1.42,1551
1,NSW,128,Emu Heights,435,39.33,671,60.67,1106,99.1,10,0.9,1116
1,NSW,128,Emu Plains,374,37.1,634,62.9,1008,98.63,14,1.37,1022
1,NSW,128,Emu Plains Central,220,36.24,387,63.76,607,98.54,9,1.46,616
1,NSW,128,Emu Plains LINDSAY PPVC,1881,27.73,4902,72.27,6783,99.2,55,0.8,6838
1,NSW,133,Emu Plains MACQUARIE PPVC,841,43.4,1097,56.6,1938,99.44,11,0.56,1949
1,NSW,128,Emu Plains North,256,43.69,330,56.31,586,97.67,14,2.33,600
1,NSW,144,Enfield (Reid),128,50,128,50,256,97.34,7,2.66,263
1,NSW,251,Enfield (Watson),572,44.38,717,55.62,1289,98.62,18,1.38,1307
1,NSW,251,Enfield South,278,36.2,490,63.8,768,98.08,15,1.92,783
1,NSW,251,Enfield West,324,40.91,468,59.09,792,98.39,13,1.61,805
1,NSW,124,Engadine,991,46.55,1138,53.45,2129,98.84,25,1.16,2154
1,NSW,112,Engadine COOK PPVC,131,38.99,205,61.01,336,98.53,5,1.47,341
1,NSW,114,Engadine CUNNINGHAM PPVC,441,41.8,614,58.2,1055,99.43,6,0.57,1061
1,NSW,124,Engadine East,146,45.91,172,54.09,318,100,0,0,318
1,NSW,124,Engadine HUGHES PPVC,4228,36.56,7335,63.44,11563,99.28,84,0.72,11647
1,NSW,124,Engadine North,445,46.02,522,53.98,967,99.28,7,0.72,974
1,NSW,124,Engadine South,327,48.3,350,51.7,677,97.83,15,2.17,692
1,NSW,124,Engadine West,730,45.68,868,54.32,1598,98.95,17,1.05,1615
1,NSW,121,Enmore,1116,83.35,223,16.65,1339,99.55,6,0.45,1345
1,NSW,105,Epping,981,50.67,955,49.33,1936,98.37,32,1.63,1968
1,NSW,105,Epping BENNELONG PPVC,4483,47.48,4958,52.52,9441,98.94,101,1.06,9542
1,NSW,106,Epping BEROWRA PPVC,720,49.38,738,50.62,1458,99.73,4,0.27,1462
1,NSW,105,Epping East,1083,56.44,836,43.56,1919,98.92,21,1.08,1940
1,NSW,105,Epping Heights,527,55.65,420,44.35,947,98.85,11,1.15,958
1,NSW,105,Epping North,923,58.98,642,41.02,1565,99.68,5,0.32,1570
1,NSW,140,Epping PARRAMATTA PPVC,995,38.46,1592,61.54,2587,99.08,24,0.92,2611
1,NSW,105,Epping West,769,53.89,658,46.11,1427,98.82,17,1.18,1444
1,NSW,146,Erina,629,40.24,934,59.76,1563,98.12,30,1.88,1593
1,NSW,146,Erina Central,476,44.95,583,55.05,1059,99.16,9,0.84,1068
1,NSW,115,Erina DOBELL PPVC,737,37.66,1220,62.34,1957,98.99,20,1.01,1977
1,NSW,115,Erina Heights (Dobell),178,50.14,177,49.86,355,98.89,4,1.11,359
1,NSW,146,Erina Heights (Robertson),342,47.9,372,52.1,714,99.3,5,0.7,719
1,NSW,146,Erina ROBERTSON PPVC,4602,37.61,7635,62.39,12237,99.28,89,0.72,12326
1,NSW,105,Ermington Central,624,46.33,723,53.67,1347,98.18,25,1.82,1372
1,NSW,105,Ermington West (Bennelong),713,42.11,980,57.89,1693,98.26,30,1.74,1723
1,NSW,140,Ermington West (Parramatta),102,42.15,140,57.85,242,98.78,3,1.22,245
1,NSW,120,Erowal Bay,152,44.31,191,55.69,343,98.56,5,1.44,348
1,NSW,315,Erskine Park,634,29.74,1498,70.26,2132,98.25,38,1.75,2170
1,NSW,315,Erskine Park Central,129,31.16,285,68.84,414,99.28,3,0.72,417
1,NSW,149,Erskineville,1966,83.87,378,16.13,2344,99.24,18,0.76,2362
1,NSW,149,Erskineville North,1284,88.25,171,11.75,1455,99.52,7,0.48,1462
1,NSW,131,Eschol Park,531,30.61,1204,69.39,1735,98.75,22,1.25,1757
1,NSW,250,Estella,565,42.16,775,57.84,1340,98.67,18,1.33,1358
1,NSW,146,Ettalong,455,44.26,573,55.74,1028,98.09,20,1.91,1048
1,NSW,146,Ettalong Central,472,45.38,568,54.62,1040,98.58,15,1.42,1055
1,NSW,139,Euabalong West,13,14.94,74,85.06,87,100,0,0,87
1,NSW,250,Euberta,25,22.52,86,77.48,111,98.23,2,1.77,113
1,NSW,109,Eugowra,76,19.84,307,80.16,383,99.22,3,0.78,386
1,NSW,139,Eumungerie,20,10.58,169,89.42,189,100,0,0,189
1,NSW,113,Eungai Creek,112,29.4,269,70.6,381,98.7,5,1.3,386
1,NSW,145,Eureka,95,61.69,59,38.31,154,98.72,2,1.28,156
1,NSW,118,Euston,28,10.77,232,89.23,260,99.24,2,0.76,262
1,NSW,138,Evans Head,522,34.92,973,65.08,1495,99.01,15,0.99,1510
1,NSW,145,Ewingsdale,120,71.86,47,28.14,167,97.66,4,2.34,171
1,NSW,145,Ewingsdale PPVC,0,0,0,0,0,0,0,0,0
1,NSW,125,Exeter,210,51.47,198,48.53,408,97.61,10,2.39,418
1,NSW,107,Fairfield BLAXLAND PPVC,463,40.61,677,59.39,1140,97.35,31,2.65,1171
1,NSW,315,Fairfield Central,431,42.76,577,57.24,1008,96.74,34,3.26,1042
1,NSW,119,Fairfield FOWLER PPVC,4735,44.31,5952,55.69,10687,96.97,334,3.03,11021
1,NSW,315,Fairfield Heights,520,34.41,991,65.59,1511,97.67,36,2.33,1547
1,NSW,315,Fairfield MCMAHON PPVC,6320,42.6,8515,57.4,14835,97.25,420,2.75,15255
1,NSW,140,Fairfield PARRAMATTA PPVC,429,41.69,600,58.31,1029,97.91,22,2.09,1051
1,NSW,315,Fairfield South,413,37.72,682,62.28,1095,98.29,19,1.71,1114
1,NSW,153,Fairfield WERRIWA PPVC,406,38.85,639,61.15,1045,97.66,25,2.34,1070
1,NSW,119,Fairfield West (Fowler),133,34.55,252,65.45,385,95.77,17,4.23,402
1,NSW,315,Fairfield West (McMahon),388,36.6,672,63.4,1060,97.52,27,2.48,1087
1,NSW,315,Fairfield West Central,312,48.6,330,51.4,642,98.17,12,1.83,654
1,NSW,151,Fairlight,532,68.47,245,31.53,777,98.98,8,1.02,785
1,NSW,138,Fairy Hill,23,12.23,165,87.77,188,99.47,1,0.53,189
1,NSW,114,Fairy Meadow,637,49.92,639,50.08,1276,99.07,12,0.93,1288
1,NSW,120,Falls Creek,99,32.67,204,67.33,303,99.02,3,0.98,306
1,NSW,126,Fassifern,197,39.72,299,60.28,496,98.22,9,1.78,505
1,NSW,133,Faulconbridge,704,60.22,465,39.78,1169,99.15,10,0.85,1179
1,NSW,145,Federal,225,70.75,93,29.25,318,99.38,2,0.63,320
1,NSW,126,Fennell Bay,344,35.5,625,64.5,969,98.68,13,1.32,982
1,NSW,249,Fern Bay,586,36.47,1021,63.53,1607,99.14,14,0.86,1621
1,NSW,145,Fernleigh,120,65.93,62,34.07,182,98.38,3,1.62,185
1,NSW,139,Fifield,16,21.62,58,78.38,74,98.67,1,1.33,75
1,NSW,114,Figtree,743,42.14,1020,57.86,1763,98.93,19,1.07,1782
1,NSW,114,Figtree Heights,503,54.2,425,45.8,928,98.83,11,1.17,939
1,NSW,114,Figtree West,392,57.39,291,42.61,683,98.7,9,1.3,692
1,NSW,118,Finley,196,16.75,974,83.25,1170,99.41,7,0.59,1177
1,NSW,144,Five Dock,937,53.36,819,46.64,1756,97.94,37,2.06,1793
1,NSW,144,Five Dock Central,580,40.96,836,59.04,1416,98.74,18,1.26,1434
1,NSW,144,Five Dock East,302,44.94,370,55.06,672,98.25,12,1.75,684
1,NSW,144,Flemington,961,54.6,799,45.4,1760,98.6,25,1.4,1785
1,NSW,136,Fletcher,583,48.38,622,51.62,1205,99.01,12,0.99,1217
1,NSW,150,Flinders Central,635,36,1129,64,1764,98.71,23,1.29,1787
1,NSW,148,Floraville,554,39.6,845,60.4,1399,98.52,21,1.48,1420
1,NSW,250,Forbes,256,26.18,722,73.82,978,98.69,13,1.31,991
1,NSW,250,Forbes North,167,22.81,565,77.19,732,97.99,15,2.01,747
1,NSW,250,Forbes PPVC,539,16.41,2746,83.59,3285,99.27,24,0.73,3309
1,NSW,250,Forbes South,108,20.04,431,79.96,539,99.08,5,0.92,544
1,NSW,250,Forest Hill,270,29.7,639,70.3,909,98.7,12,1.3,921
1,NSW,149,Forest Lodge,1267,81.48,288,18.52,1555,99.23,12,0.77,1567
1,NSW,132,Forestville (Mackellar),794,56.71,606,43.29,1400,98.8,17,1.2,1417
1,NSW,151,Forestville (Warringah),717,53.03,635,46.97,1352,98.76,17,1.24,1369
1,NSW,151,Forestville East,356,50.86,344,49.14,700,98.73,9,1.27,709
1,NSW,115,Forresters Beach,344,37.23,580,62.77,924,98.72,12,1.28,936
1,NSW,130,Forster East,363,42.91,483,57.09,846,98.14,16,1.86,862
1,NSW,130,Forster Keys,262,31.41,572,68.59,834,98.93,9,1.07,843
1,NSW,130,Forster South,551,30.75,1241,69.25,1792,98.08,35,1.92,1827
1,NSW,130,Forster-Tuncurry PPVC,2893,22.7,9852,77.3,12745,99.23,99,0.77,12844
1,NSW,113,Frederickton,80,18.87,344,81.13,424,99.3,3,0.7,427
1,NSW,133,Freemans Reach,209,21.98,742,78.02,951,98.55,14,1.45,965
1,NSW,132,Frenchs Forest (Mackellar),966,56.66,739,43.34,1705,98.55,25,1.45,1730
1,NSW,151,Frenchs Forest (Warringah),307,55.12,250,44.88,557,99.11,5,0.89,562
1,NSW,132,Frenchs Forest East,728,54.33,612,45.67,1340,98.89,15,1.11,1355
1,NSW,132,Frenchs Forest MACKELLAR PPVC,2014,38.49,3218,61.51,5232,99.37,33,0.63,5265
1,NSW,132,Frenchs Forest North,928,51.3,881,48.7,1809,98.8,22,1.2,1831
1,NSW,151,Frenchs Forest WARRINGAH PPVC,180,39.56,275,60.44,455,99.56,2,0.44,457
1,NSW,151,Freshwater,616,66.02,317,33.98,933,98.94,10,1.06,943
1,NSW,151,Freshwater Central,710,65.74,370,34.26,1080,99.08,10,0.92,1090
1,NSW,151,Freshwater North,398,69.22,177,30.78,575,98.97,6,1.03,581
1,NSW,106,Galston,579,38.29,933,61.71,1512,99.08,14,0.92,1526
1,NSW,250,Ganmain,96,21.1,359,78.9,455,99.56,2,0.44,457
1,NSW,148,Garden Suburb,553,49.73,559,50.27,1112,98.58,16,1.42,1128
1,NSW,148,Gateshead,318,40.87,460,59.13,778,99.23,6,0.77,784
1,NSW,107,Georges Hall,460,27.33,1223,72.67,1683,97.74,39,2.26,1722
1,NSW,136,Georgetown,396,67.46,191,32.54,587,98.82,7,1.18,594
1,NSW,118,Gerogery,51,21.43,187,78.57,238,98.35,4,1.65,242
1,NSW,120,Gerringong,621,56,488,44,1109,99.02,11,0.98,1120
1,NSW,120,Gerringong North,358,56.29,278,43.71,636,98.6,9,1.4,645
1,NSW,120,Gerroa,121,50.63,118,49.37,239,98.35,4,1.65,243
1,NSW,109,Geurie,72,19.25,302,80.75,374,99.47,2,0.53,376
1,NSW,135,Gilgai,32,13.85,199,86.15,231,99.57,1,0.43,232
1,NSW,139,Gilgandra,333,20.18,1317,79.82,1650,99.34,11,0.66,1661
1,NSW,249,Gillieston Heights,550,33.89,1073,66.11,1623,99.14,14,0.86,1637
1,NSW,122,Girraween,1139,54.92,935,45.08,2074,99.14,18,0.86,2092
1,NSW,122,Girraween West,151,51.36,143,48.64,294,98.66,4,1.34,298
1,NSW,105,Gladesville (Bennelong),1081,55.72,859,44.28,1940,98.63,27,1.37,1967
1,NSW,137,Gladesville (North Sydney),456,57.5,337,42.5,793,99,8,1,801
1,NSW,105,Gladesville North,474,53.8,407,46.2,881,98.44,14,1.56,895
1,NSW,113,Gladstone,121,20.61,466,79.39,587,98.49,9,1.51,596
1,NSW,149,Glebe,907,74.28,314,25.72,1221,98.87,14,1.13,1235
1,NSW,149,Glebe East,366,62.46,220,37.54,586,97.02,18,2.98,604
1,NSW,121,Glebe GRAYNDLER PPVC,1577,79.41,409,20.59,1986,99.45,11,0.55,1997
1,NSW,149,Glebe North,216,73.22,79,26.78,295,99.66,1,0.34,296
1,NSW,149,Glebe SYDNEY PPVC,2991,78.11,838,21.89,3829,99.25,29,0.75,3858
1,NSW,149,Glebe West,877,77.13,260,22.87,1137,99.56,5,0.44,1142
1,NSW,131,Gledswood Hills,799,36.97,1362,63.03,2161,98.99,22,1.01,2183
1,NSW,131,Glen Alpine,1139,33.46,2265,66.54,3404,98.5,52,1.5,3456
1,NSW,135,Glen Innes,33,29.73,78,70.27,111,98.23,2,1.77,113
1,NSW,135,Glen Innes PPVC,688,18.1,3114,81.9,3802,99.24,29,0.76,3831
1,NSW,135,Glen Innes West,291,28.25,739,71.75,1030,98.56,15,1.44,1045
1,NSW,133,Glenbrook,912,59.61,618,40.39,1530,99.35,10,0.65,1540
1,NSW,135,Glencoe,11,13.92,68,86.08,79,100,0,0,79
1,NSW,126,Glendale,437,39.91,658,60.09,1095,98.56,16,1.44,1111
1,NSW,111,Glendenning,949,46.86,1076,53.14,2025,98.4,33,1.6,2058
1,NSW,126,Glendon,39,17.11,189,82.89,228,99.13,2,0.87,230
1,NSW,136,Glendore,694,47.93,754,52.07,1448,98.37,24,1.63,1472
1,NSW,153,Glenfield,782,53.42,682,46.58,1464,97.99,30,2.01,1494
1,NSW,153,Glenfield East,470,44.63,583,55.37,1053,98.23,19,1.77,1072
1,NSW,250,Glenfield Park,604,32.18,1273,67.82,1877,98.58,27,1.42,1904
1,NSW,153,Glenfield West,117,53.92,100,46.08,217,99.54,1,0.46,218
1,NSW,106,Glenhaven,654,38.95,1025,61.05,1679,99,17,1,1696
1,NSW,113,Gleniffer,129,56.09,101,43.91,230,99.14,2,0.86,232
1,NSW,128,Glenmore Park,431,35.1,797,64.9,1228,98.79,15,1.21,1243
1,NSW,128,Glenmore Park Central,528,30.82,1185,69.18,1713,98.9,19,1.1,1732
1,NSW,128,Glenmore Park East,265,34.24,509,65.76,774,98.72,10,1.28,784
1,NSW,128,Glenmore Park PPVC,2216,24.59,6797,75.41,9013,99.02,89,0.98,9102
1,NSW,128,Glenmore Park South,621,38.29,1001,61.71,1622,98.84,19,1.16,1641
1,NSW,115,Glenning Valley,154,40,231,60,385,98.97,4,1.03,389
1,NSW,106,Glenorie,420,29.7,994,70.3,1414,98.47,22,1.53,1436
1,NSW,106,Glenorie West,158,28.88,389,71.12,547,99.27,4,0.73,551
1,NSW,150,Glenquarry,38,37.62,63,62.38,101,99.02,1,0.98,102
1,NSW,138,Glenreagh,187,28.59,467,71.41,654,99.09,6,0.91,660
1,NSW,109,Glenroi,200,30.82,449,69.18,649,98.33,11,1.67,660
1,NSW,118,Glenroy,520,37.82,855,62.18,1375,98.64,19,1.36,1394
1,NSW,122,Glenwood,615,44.89,755,55.11,1370,98.63,19,1.37,1389
1,NSW,122,Glenwood Central,529,53.76,455,46.24,984,98.89,11,1.11,995
1,NSW,122,Glenwood South,875,52.46,793,47.54,1668,98.99,17,1.01,1685
1,NSW,122,Glenwood West,1129,50.79,1094,49.21,2223,99.24,17,0.76,2240
1,NSW,133,Glossodia,212,22.18,744,77.82,956,98.76,12,1.24,968
1,NSW,130,Gloucester,267,33.33,534,66.67,801,98.65,11,1.35,812
1,NSW,130,Gloucester PPVC,444,19.43,1841,80.57,2285,99.35,15,0.65,2300
1,NSW,139,Goodooga,47,61.84,29,38.16,76,98.7,1,1.3,77
1,NSW,117,Googong,1233,50.51,1208,49.49,2441,98.67,33,1.33,2474
1,NSW,118,Goolgowi,40,16.26,206,83.74,246,98.4,4,1.6,250
1,NSW,138,Goolmangar,173,40.71,252,59.29,425,98.61,6,1.39,431
1,NSW,250,Gooloogong,26,12.56,181,87.44,207,100,0,0,207
1,NSW,138,Goonellabah,431,45.37,519,54.63,950,99.27,7,0.73,957
1,NSW,138,Goonellabah PPVC,1214,27.11,3264,72.89,4478,99.2,36,0.8,4514
1,NSW,138,Goonellabah South,690,40.97,994,59.03,1684,98.59,24,1.41,1708
1,NSW,108,Gordon,1040,53.31,911,46.69,1951,98.88,22,1.12,1973
1,NSW,108,Gordon East,845,58.12,609,41.88,1454,99.32,10,0.68,1464
1,NSW,108,Gordon PPVC,3668,48.86,3839,51.14,7507,99.35,49,0.65,7556
1,NSW,108,Gordon West,827,58.36,590,41.64,1417,98.95,15,1.05,1432
1,NSW,115,Gorokan,467,31.9,997,68.1,1464,97.47,38,2.53,1502
1,NSW,146,Gosford,332,53.04,294,46.96,626,99.05,6,0.95,632
1,NSW,115,Gosford DOBELL PPVC,1471,38.03,2397,61.97,3868,98.98,40,1.02,3908
1,NSW,146,Gosford East,935,50.46,918,49.54,1853,98.99,19,1.01,1872
1,NSW,146,Gosford North,437,49.66,443,50.34,880,98.54,13,1.46,893
1,NSW,146,Gosford ROBERTSON PPVC,3524,41.22,5025,58.78,8549,98.94,92,1.06,8641
1,NSW,146,Gosford West,485,47,547,53,1032,99.04,10,0.96,1042
1,NSW,125,Goulburn,576,32.38,1203,67.62,1779,98.89,20,1.11,1799
1,NSW,125,Goulburn Crestwood,93,29.15,226,70.85,319,97.55,8,2.45,327
1,NSW,125,Goulburn North,305,29.99,712,70.01,1017,98.93,11,1.07,1028
1,NSW,125,Goulburn PPVC,2718,22.52,9351,77.48,12069,99.28,87,0.72,12156
1,NSW,125,Goulburn South,423,27.43,1119,72.57,1542,99.16,13,0.84,1555
1,NSW,125,Goulburn West,281,32.83,575,67.17,856,99.42,5,0.58,861
1,NSW,125,Grabben Gullen,35,19.23,147,80.77,182,99.45,1,0.55,183
1,NSW,138,Grafton,276,24.13,868,75.87,1144,99.22,9,0.78,1153
1,NSW,138,Grafton Central,565,29.64,1341,70.36,1906,98.45,30,1.55,1936
1,NSW,138,Grafton East,202,32.63,417,67.37,619,98.88,7,1.12,626
1,NSW,138,Grafton North,123,21.58,447,78.42,570,100,0,0,570
1,NSW,138,Grafton PPVC,2274,21.46,8322,78.54,10596,99.02,105,0.98,10701
1,NSW,140,Granville,824,44.32,1035,55.68,1859,97.48,48,2.52,1907
1,NSW,107,Granville East (Blaxland),86,34.54,163,65.46,249,95.77,11,4.23,260
1,NSW,140,Granville East (Parramatta),593,35.47,1079,64.53,1672,95.82,73,4.18,1745
1,NSW,140,Granville North,317,51.97,293,48.03,610,97.13,18,2.87,628
1,NSW,107,Granville South (Blaxland),619,33.97,1203,66.03,1822,95.89,78,4.11,1900
1,NSW,140,Granville South (Parramatta),59,29.06,144,70.94,203,94.42,12,5.58,215
1,NSW,139,Gravesend,13,10,117,90,130,99.24,1,0.76,131
1,NSW,124,Grays Point,634,53.73,546,46.27,1180,99.16,10,0.84,1190
1,NSW,146,Green Point,480,44.61,596,55.39,1076,99.26,8,0.74,1084
1,NSW,153,Green Valley,66,36.67,114,63.33,180,98.36,3,1.64,183
1,NSW,153,Green Valley East,388,37.2,655,62.8,1043,96.75,35,3.25,1078
1,NSW,153,Green Valley North,785,37.42,1313,62.58,2098,97.72,49,2.28,2147
1,NSW,153,Green Valley West,500,29.36,1203,70.64,1703,98.16,32,1.84,1735
1,NSW,251,Greenacre,331,40.97,477,59.03,808,95.62,37,4.38,845
1,NSW,251,Greenacre Central,735,27.27,1960,72.73,2695,96.11,109,3.89,2804
1,NSW,251,Greenacre North,792,37.84,1301,62.16,2093,94.83,114,5.17,2207
1,NSW,251,Greenacre West,453,32.95,922,67.05,1375,96.83,45,3.17,1420
1,NSW,250,Greenethorpe,29,22.14,102,77.86,131,98.5,2,1.5,133
1,NSW,119,Greenfield Park,480,36.75,826,63.25,1306,96.6,46,3.4,1352
1,NSW,112,Greenhills Beach,404,44.59,502,55.41,906,99.12,8,0.88,914
1,NSW,120,Greenwell Point,139,31.45,303,68.55,442,98.66,6,1.34,448
1,NSW,137,Greenwich,384,65.53,202,34.47,586,99.66,2,0.34,588
1,NSW,137,Greenwich North,934,70.07,399,29.93,1333,99.63,5,0.37,1338
1,NSW,131,Gregory Hills,944,36.27,1659,63.73,2603,98.67,35,1.33,2638
1,NSW,250,Grenfell,270,19.74,1098,80.26,1368,99.27,10,0.73,1378
1,NSW,130,Gresford,116,25.11,346,74.89,462,99.35,3,0.65,465
1,NSW,126,Greta,486,33.66,958,66.34,1444,99.18,12,0.82,1456
1,NSW,315,Greystanes,656,31.81,1406,68.19,2062,98.24,37,1.76,2099
1,NSW,315,Greystanes Central,238,29.2,577,70.8,815,99.27,6,0.73,821
1,NSW,315,Greystanes East,422,24.71,1286,75.29,1708,99.07,16,0.93,1724
1,NSW,315,Greystanes North,545,33.68,1073,66.32,1618,99.02,16,0.98,1634
1,NSW,315,Greystanes North East,486,33.54,963,66.46,1449,98.1,28,1.9,1477
1,NSW,315,Greystanes South,369,34.36,705,65.64,1074,99.08,10,0.92,1084
1,NSW,315,Greystanes West,41,32.28,86,67.72,127,100,0,0,127
1,NSW,118,Griffith,216,29.03,528,70.97,744,99.2,6,0.8,750
1,NSW,118,Griffith East,382,26.22,1075,73.78,1457,97.98,30,2.02,1487
1,NSW,118,Griffith North,303,25.06,906,74.94,1209,99.18,10,0.82,1219
1,NSW,118,Griffith PPVC,1133,18.92,4855,81.08,5988,98.96,63,1.04,6051
1,NSW,118,Griffith West,302,26.08,856,73.92,1158,98.05,23,1.95,1181
1,NSW,133,Grose Wold,207,32.09,438,67.91,645,98.77,8,1.23,653
1,NSW,315,Guildford,640,42.08,881,57.92,1521,96.51,55,3.49,1576
1,NSW,315,Guildford East,581,32.96,1182,67.04,1763,96.13,71,3.87,1834
1,NSW,107,Guildford North (Blaxland),30,35.29,55,64.71,85,93.41,6,6.59,91
1,NSW,315,Guildford North (McMahon),193,42.14,265,57.86,458,96.42,17,3.58,475
1,NSW,140,Guildford North (Parramatta),207,40.35,306,59.65,513,97.16,15,2.84,528
1,NSW,107,Guildford South,218,28.13,557,71.87,775,97,24,3,799
1,NSW,315,Guildford West,630,30.57,1431,69.43,2061,96.72,70,3.28,2131
1,NSW,139,Gulargambone,74,24.34,230,75.66,304,99.02,3,0.98,307
1,NSW,109,Gulgong,242,18.46,1069,81.54,1311,98.94,14,1.06,1325
1,NSW,138,Gulmarrad,180,27.86,466,72.14,646,98.33,11,1.67,657
1,NSW,250,Gundagai,203,21.08,760,78.92,963,99.07,9,0.93,972
1,NSW,250,Gundagai South,83,23.25,274,76.75,357,98.08,7,1.92,364
1,NSW,117,Gundaroo,393,60.74,254,39.26,647,99.69,2,0.31,649
1,NSW,135,Gundy,40,24.54,123,75.46,163,98.79,2,1.21,165
1,NSW,117,Gungahlin EDEN-MONARO PPVC,200,41.67,280,58.33,480,99.59,2,0.41,482
1,NSW,139,Gunnedah,362,21.69,1307,78.31,1669,98.64,23,1.36,1692
1,NSW,139,Gunnedah PPVC,664,14.64,3871,85.36,4535,99.13,40,0.87,4575
1,NSW,139,Gunnedah South,129,25.15,384,74.85,513,98.65,7,1.35,520
1,NSW,125,Gunning,164,32.87,335,67.13,499,98.23,9,1.77,508
1,NSW,135,Guyra,167,18.23,749,81.77,916,99.13,8,0.87,924
1,NSW,148,Gwandalan,416,28.49,1044,71.51,1460,98.58,21,1.42,1481
1,NSW,114,Gwynneville,699,59.04,485,40.96,1184,97.93,25,2.07,1209
1,NSW,112,Gymea,663,45.76,786,54.24,1449,98.98,15,1.02,1464
1,NSW,112,Gymea Bay,1079,47.93,1172,52.07,2251,98.38,37,1.62,2288
1,NSW,112,Gymea Bay North,266,46.5,306,53.5,572,99.31,4,0.69,576
1,NSW,112,Gymea North,357,41.32,507,58.68,864,98.52,13,1.48,877
1,NSW,121,Haberfield,470,63.34,272,36.66,742,99.33,5,0.67,747
1,NSW,121,Haberfield West,397,59.43,271,40.57,668,99.7,2,0.3,670
1,NSW,130,Hallidays Point,337,34.14,650,65.86,987,99.2,8,0.8,995
1,NSW,136,Hamilton,1502,69.96,645,30.04,2147,98.76,27,1.24,2174
1,NSW,136,Hamilton North,338,58.18,243,41.82,581,98.81,7,1.19,588
1,NSW,136,Hamilton South,1114,62.41,671,37.59,1785,98.62,25,1.38,1810
1,NSW,115,Hamlyn Terrace,710,34.82,1329,65.18,2039,98.17,38,1.83,2077
1,NSW,124,Hammondville,471,38.45,754,61.55,1225,98.16,23,1.84,1248
1,NSW,109,Hampton,33,33.33,66,66.67,99,100,0,0,99
1,NSW,130,Hannam Vale,71,39.01,111,60.99,182,100,0,0,182
1,NSW,118,Hanwood,140,16.34,717,83.66,857,98.85,10,1.15,867
1,NSW,250,Harden,106,23.14,352,76.86,458,98.07,9,1.93,467
1,NSW,146,Hardys Bay,519,69.66,226,30.34,745,98.68,10,1.32,755
1,NSW,109,Hargraves,27,20.15,107,79.85,134,100,0,0,134
1,NSW,130,Harrington,327,21.76,1176,78.24,1503,99.34,10,0.66,1513
1,NSW,131,Harrington Park,493,30.17,1141,69.83,1634,98.49,25,1.51,1659
1,NSW,131,Harrington Park Central,496,30.54,1128,69.46,1624,98.84,19,1.16,1643
1,NSW,109,Hartley,163,36.55,283,63.45,446,99.33,3,0.67,449
1,NSW,138,Harwood Island,81,26.13,229,73.87,310,99.04,3,0.96,313
1,NSW,111,Hassall Grove,867,35.78,1556,64.22,2423,98.18,45,1.82,2468
1,NSW,145,Hastings Point,126,38.65,200,61.35,326,99.39,2,0.61,328
1,NSW,113,Hat Head,82,39.81,124,60.19,206,99.04,2,0.96,208
1,NSW,130,Hawks Nest,202,33.39,403,66.61,605,99.02,6,0.98,611
1,NSW,118,Hay,204,14.48,1205,85.52,1409,99.09,13,0.91,1422
1,NSW,103,Haymarket BANKS PPVC,134,48.2,144,51.8,278,98.93,3,1.07,281
1,NSW,104,Haymarket BARTON PPVC,289,58.5,205,41.5,494,98.8,6,1.2,500
1,NSW,105,Haymarket BENNELONG PPVC,183,59.8,123,40.2,306,99.67,1,0.33,307
1,NSW,106,Haymarket BEROWRA PPVC,95,51.35,90,48.65,185,99.46,1,0.54,186
1,NSW,107,Haymarket BLAXLAND PPVC,66,46.15,77,53.85,143,100,0,0,143
1,NSW,108,Haymarket BRADFIELD PPVC,129,51.81,120,48.19,249,100,0,0,249
1,NSW,112,Haymarket COOK PPVC,103,49.52,105,50.48,208,99.52,1,0.48,209
1,NSW,119,Haymarket FOWLER PPVC,65,56.03,51,43.97,116,98.31,2,1.69,118
1,NSW,121,Haymarket GRAYNDLER PPVC,528,79.04,140,20.96,668,99.55,3,0.45,671
1,NSW,122,Haymarket GREENWAY PPVC,71,54.2,60,45.8,131,98.5,2,1.5,133
1,NSW,124,Haymarket HUGHES PPVC,105,57.69,77,42.31,182,99.45,1,0.55,183
1,NSW,127,Haymarket KINGSFORD SMITH PPVC,352,60.17,233,39.83,585,99.32,4,0.68,589
1,NSW,132,Haymarket MACKELLAR PPVC,97,62.99,57,37.01,154,97.47,4,2.53,158
1,NSW,134,Haymarket MITCHELL PPVC,104,54.17,88,45.83,192,98.97,2,1.03,194
1,NSW,137,Haymarket NORTH SYDNEY PPVC,278,61.37,175,38.63,453,98.91,5,1.09,458
1,NSW,140,Haymarket PARRAMATTA PPVC,116,49.79,117,50.21,233,100,0,0,233
1,NSW,144,Haymarket REID PPVC,300,53.29,263,46.71,563,99.29,4,0.71,567
1,NSW,149,Haymarket SYDNEY PPVC,4072,64.29,2262,35.71,6334,98.65,87,1.35,6421
1,NSW,151,Haymarket WARRINGAH PPVC,162,64.03,91,35.97,253,99.61,1,0.39,254
1,NSW,251,Haymarket WATSON PPVC,129,52.23,118,47.77,247,99.2,2,0.8,249
1,NSW,152,Haymarket WENTWORTH PPVC,385,68.38,178,31.62,563,98.95,6,1.05,569
1,NSW,153,Haymarket WERRIWA PPVC,72,47.68,79,52.32,151,98.69,2,1.31,153
1,NSW,133,Hazelbrook,830,61.71,515,38.29,1345,98.53,20,1.47,1365
1,NSW,124,Heathcote,656,47.43,727,52.57,1383,99,14,1,1397
1,NSW,124,Heathcote East,305,44.4,382,55.6,687,98.28,12,1.72,699
1,NSW,111,Hebersham,541,37.16,915,62.84,1456,97.78,33,2.22,1489
1,NSW,153,Heckenberg,426,35.21,784,64.79,1210,97.19,35,2.81,1245
1,NSW,114,Helensburgh,991,47.94,1076,52.06,2067,98.62,29,1.38,2096
1,NSW,114,Helensburgh North,423,51.77,394,48.23,817,98.67,11,1.33,828
1,NSW,118,Henty,105,17.56,493,82.44,598,98.84,7,1.16,605
1,NSW,109,Hermitage,90,28.66,224,71.34,314,98.43,5,1.57,319
1,NSW,130,Herons Creek,29,34.94,54,65.06,83,98.81,1,1.19,84
1,NSW,113,Hibbard,219,32.35,458,67.65,677,98.12,13,1.88,690
1,NSW,125,Hill Top,319,27.03,861,72.97,1180,98.83,14,1.17,1194
1,NSW,148,Hillsborough,504,49.61,512,50.39,1016,98.93,11,1.07,1027
1,NSW,127,Hillsdale,1205,50.21,1195,49.79,2400,98.56,35,1.44,2435
1,NSW,118,Hillston,92,14.67,535,85.33,627,99.21,5,0.79,632
1,NSW,135,Hillvue,291,29.28,703,70.72,994,98.91,11,1.09,1005
1,NSW,135,Hillvue West,220,27.16,590,72.84,810,98.3,14,1.7,824
1,NSW,153,Hinchinbrook,474,33.47,942,66.53,1416,98.06,28,1.94,1444
1,NSW,153,Hinchinbrook East,313,38.17,507,61.83,820,97.5,21,2.5,841
1,NSW,153,Hinchinbrook North,344,36.29,604,63.71,948,97.93,20,2.07,968
1,NSW,130,Hinton,212,30.99,472,69.01,684,99.42,4,0.58,688
1,NSW,133,Hobartville,312,27.59,819,72.41,1131,98.95,12,1.05,1143
1,NSW,118,Holbrook,183,18.77,792,81.23,975,98.78,12,1.22,987
1,NSW,115,Holgate,299,49.83,301,50.17,600,98.68,8,1.32,608
1,NSW,140,Holroyd,263,41.09,377,58.91,640,97.86,14,2.14,654
1,NSW,124,Holsworthy,400,52.91,356,47.09,756,98.82,9,1.18,765
1,NSW,124,Holsworthy West,90,58.06,65,41.94,155,98.1,3,1.9,158
1,NSW,144,Homebush,1415,57.01,1067,42.99,2482,98.45,39,1.55,2521
1,NSW,144,Homebush North,671,49.85,675,50.15,1346,98.75,17,1.25,1363
1,NSW,153,Horningsea Park,427,34.74,802,65.26,1229,98.32,21,1.68,1250
1,NSW,106,Hornsby (Berowra),581,54.61,483,45.39,1064,99.16,9,0.84,1073
1,NSW,108,Hornsby (Bradfield),211,57.03,159,42.97,370,98.67,5,1.33,375
1,NSW,106,Hornsby BEROWRA PPVC,2340,46.93,2646,53.07,4986,98.93,54,1.07,5040
1,NSW,108,Hornsby BRADFIELD PPVC,1715,47.95,1862,52.05,3577,98.87,41,1.13,3618
1,NSW,106,Hornsby Central (Berowra),183,52.59,165,47.41,348,98.86,4,1.14,352
1,NSW,108,Hornsby Central (Bradfield),920,52.36,837,47.64,1757,98.71,23,1.29,1780
1,NSW,108,Hornsby East,631,57.68,463,42.32,1094,98.2,20,1.8,1114
1,NSW,106,Hornsby Heights,1168,56.43,902,43.57,2070,99.09,19,0.91,2089
1,NSW,106,Hornsby North,787,57.87,573,42.13,1360,98.98,14,1.02,1374
1,NSW,106,Hornsby South,417,53.88,357,46.12,774,98.98,8,1.02,782
1,NSW,106,Hornsby West (Berowra),428,55.23,347,44.77,775,98.85,9,1.15,784
1,NSW,108,Hornsby West (Bradfield),187,47.22,209,52.78,396,99,4,1,400
1,NSW,150,Horsley,634,39.58,968,60.42,1602,98.77,20,1.23,1622
1,NSW,315,Horsley Park,165,16.18,855,83.82,1020,99.03,10,0.97,1030
1,NSW,150,Horsley South,340,41.56,478,58.44,818,98.32,14,1.68,832
1,NSW,118,Howlong,220,17.42,1043,82.58,1263,98.21,23,1.79,1286
1,NSW,153,Hoxton Park,512,31.7,1103,68.3,1615,97.58,40,2.42,1655
1,NSW,118,Hume,262,33.29,525,66.71,787,98.62,11,1.38,798
1,NSW,137,Hunters Hill,982,49.52,1001,50.48,1983,99.25,15,0.75,1998
1,NSW,105,Hunters Hill North (Bennelong),621,57.98,450,42.02,1071,98.98,11,1.02,1082
1,NSW,137,Hunters Hill North (North Sydney),704,59.21,485,40.79,1189,99.33,8,0.67,1197
1,NSW,137,Hunters Hill West,723,60.05,481,39.95,1204,99.18,10,0.82,1214
1,NSW,130,Huntingdon,39,24.68,119,75.32,158,99.37,1,0.63,159
1,NSW,104,Hurlstone Park (Barton),315,68.03,148,31.97,463,99.14,4,0.86,467
1,NSW,121,Hurlstone Park (Grayndler),661,72.96,245,27.04,906,98.91,10,1.09,916
1,NSW,103,Hurstville (Banks),238,39.47,365,60.53,603,99.34,4,0.66,607
1,NSW,104,Hurstville (Barton),697,36.25,1226,63.75,1923,97.71,45,2.29,1968
1,NSW,103,Hurstville BANKS PPVC,2166,35.85,3875,64.15,6041,98.15,114,1.85,6155
1,NSW,104,Hurstville BARTON PPVC,2200,33.58,4352,66.42,6552,98.33,111,1.67,6663
1,NSW,112,Hurstville COOK PPVC,346,33.11,699,66.89,1045,98.58,15,1.42,1060
1,NSW,103,Hurstville East (Banks),103,40.39,152,59.61,255,96.96,8,3.04,263
1,NSW,104,Hurstville East (Barton),463,37.83,761,62.17,1224,98.55,18,1.45,1242
1,NSW,103,Hurstville Grove,542,46.52,623,53.48,1165,99.15,10,0.85,1175
1,NSW,103,Hurstville South,284,38.64,451,61.36,735,98.39,12,1.61,747
1,NSW,251,Hurstville WATSON PPVC,148,39.15,230,60.85,378,99.21,3,0.79,381
1,NSW,120,Huskisson,392,49.18,405,50.82,797,99.63,3,0.38,800
1,NSW,120,Huskisson PPVC,2106,31.29,4625,68.71,6731,99.38,42,0.62,6773
1,NSW,149,Hyde Park,473,69.35,209,30.65,682,99.56,3,0.44,685
1,NSW,109,Ilford,29,20.28,114,79.72,143,99.31,1,0.69,144
1,NSW,250,Illabo,19,16.1,99,83.9,118,100,0,0,118
1,NSW,124,Illawong,694,32.72,1427,67.28,2121,99.02,21,0.98,2142
1,NSW,124,Illawong North,202,40.16,301,59.84,503,98.63,7,1.37,510
1,NSW,138,Iluka,215,26.19,606,73.81,821,98.68,11,1.32,832
1,NSW,131,Ingleburn (Macarthur),903,47.75,988,52.25,1891,98.64,26,1.36,1917
1,NSW,153,Ingleburn (Werriwa),321,56.81,244,43.19,565,98.95,6,1.05,571
1,NSW,131,Ingleburn East,265,46.25,308,53.75,573,98.28,10,1.72,583
1,NSW,131,Ingleburn MACARTHUR PPVC,3443,38.86,5416,61.14,8859,98.51,134,1.49,8993
1,NSW,131,Ingleburn South,408,39.5,625,60.5,1033,98.01,21,1.99,1054
1,NSW,153,Ingleburn WERRIWA PPVC,2697,40.27,4000,59.73,6697,99.24,51,0.76,6748
1,NSW,113,Innes Lake,432,38.37,694,61.63,1126,98.34,19,1.66,1145
1,NSW,113,Innes Lake North,308,37.42,515,62.58,823,98.68,11,1.32,834
1,NSW,135,Inverell,299,19.4,1242,80.6,1541,98.85,18,1.15,1559
1,NSW,135,Inverell East,123,15.24,684,84.76,807,99.02,8,0.98,815
1,NSW,135,Inverell PPVC,873,14.46,5164,85.54,6037,99.11,54,0.89,6091
1,NSW,136,Islington,1029,73.55,370,26.45,1399,99.57,6,0.43,1405
1,NSW,120,Jamberoo,321,50.55,314,49.45,635,98.91,7,1.09,642
1,NSW,128,Jamisontown,339,29.53,809,70.47,1148,98.8,14,1.2,1162
1,NSW,128,Jamisontown West,244,35.47,444,64.53,688,98.57,10,1.43,698
1,NSW,124,Jannali East,825,52.85,736,47.15,1561,98.73,20,1.27,1581
1,NSW,124,Jannali West,648,52.13,595,47.87,1243,99.12,11,0.88,1254
1,NSW,118,Jerilderie,91,18.96,389,81.04,480,99.38,3,0.62,483
1,NSW,117,Jerrabomberra,1132,51.15,1081,48.85,2213,98.75,28,1.25,2241
1,NSW,117,Jerrabomberra PPVC,2209,40.49,3246,59.51,5455,99.04,53,0.96,5508
1,NSW,126,Jerrys Plains,30,18.4,133,81.6,163,99.39,1,0.61,164
1,NSW,136,Jesmond North,798,53.99,680,46.01,1478,98.34,25,1.66,1503
1,NSW,148,Jewells,532,41.47,751,58.53,1283,98.62,18,1.38,1301
1,NSW,138,Jiggi,98,61.64,61,38.36,159,97.55,4,2.45,163
1,NSW,115,Jilliby,162,26.64,446,73.36,608,99.67,2,0.33,610
1,NSW,117,Jindabyne,408,55.36,329,44.64,737,98.93,8,1.07,745
1,NSW,117,Jindabyne PPVC,953,43.16,1255,56.84,2208,98.57,32,1.43,2240
1,NSW,118,Jindera,256,22.84,865,77.16,1121,98.16,21,1.84,1142
1,NSW,130,Johns River,54,27.27,144,72.73,198,99,2,1,200
1,NSW,128,Jordan Springs,1278,38.44,2047,61.56,3325,98.96,35,1.04,3360
1,NSW,250,Jugiong,30,18.87,129,81.13,159,98.15,3,1.85,162
1,NSW,250,Junee,267,27.22,714,72.78,981,99.39,6,0.61,987
1,NSW,250,Junee PPVC,363,18.3,1621,81.7,1984,99.3,14,0.7,1998
1,NSW,148,Kahibah,760,57.88,553,42.12,1313,98.65,18,1.35,1331
1,NSW,150,Kanahooka,441,38.99,690,61.01,1131,98.61,16,1.39,1147
1,NSW,109,Kandos,216,30.34,496,69.66,712,98.61,10,1.39,722
1,NSW,120,Kangaroo Valley,363,62.8,215,37.2,578,99.66,2,0.34,580
1,NSW,115,Kanwal,546,33.48,1085,66.52,1631,98.13,31,1.87,1662
1,NSW,115,Kanwal North,234,30.75,527,69.25,761,99.22,6,0.78,767
1,NSW,250,Kapooka PPVC,29,21.17,108,78.83,137,100,0,0,137
1,NSW,138,Karangi,107,36.52,186,63.48,293,99.32,2,0.68,295
1,NSW,124,Kareela,564,43.79,724,56.21,1288,99.31,9,0.69,1297
1,NSW,146,Kariong,621,36.94,1060,63.06,1681,98.19,31,1.81,1712
1,NSW,146,Kariong East,310,37.58,515,62.42,825,97.52,21,2.48,846
1,NSW,130,Karuah,220,31.93,469,68.07,689,98.71,9,1.29,698
1,NSW,133,Katoomba,636,75.89,202,24.11,838,98.36,14,1.64,852
1,NSW,133,Katoomba Central,623,69.45,274,30.55,897,97.61,22,2.39,919
1,NSW,133,Katoomba North,516,64.02,290,35.98,806,98.77,10,1.23,816
1,NSW,133,Katoomba PPVC,4806,62.65,2865,37.35,7671,98.88,87,1.12,7758
1,NSW,126,Kearsley,137,25.51,400,74.49,537,98.53,8,1.47,545
1,NSW,114,Keiraville,1099,62.73,653,37.27,1752,98.87,20,1.13,1772
1,NSW,134,Kellyville,887,42.73,1189,57.27,2076,98.95,22,1.05,2098
1,NSW,134,Kellyville East,560,41.18,800,58.82,1360,99.34,9,0.66,1369
1,NSW,134,Kellyville North,908,41.88,1260,58.12,2168,98.91,24,1.09,2192
1,NSW,134,Kellyville North West,203,37.66,336,62.34,539,99.26,4,0.74,543
1,NSW,122,Kellyville Ridge,831,45.61,991,54.39,1822,98.59,26,1.41,1848
1,NSW,134,Kellyville South,445,41.36,631,58.64,1076,98.63,15,1.37,1091
1,NSW,134,Kellyville West,498,39.97,748,60.03,1246,99.12,11,0.88,1257
1,NSW,109,Kelso,403,30.23,930,69.77,1333,98.01,27,1.99,1360
1,NSW,315,Kemps Creek (McMahon),58,19.33,242,80.67,300,99.34,2,0.66,302
1,NSW,153,Kemps Creek (Werriwa),146,19.31,610,80.69,756,99.08,7,0.92,763
1,NSW,113,Kempsey,149,27.49,393,72.51,542,98.19,10,1.81,552
1,NSW,113,Kempsey East,161,26.52,446,73.48,607,99.35,4,0.65,611
1,NSW,113,Kempsey Heights,334,31.72,719,68.28,1053,97.95,22,2.05,1075
1,NSW,113,Kempsey PPVC,1920,19.91,7723,80.09,9643,99.04,93,0.96,9736
1,NSW,113,Kempsey South,147,39.62,224,60.38,371,98.67,5,1.33,376
1,NSW,130,Kendall,264,33.21,531,66.79,795,98.88,9,1.12,804
1,NSW,127,Kensington,790,68.16,369,31.84,1159,99.23,9,0.77,1168
1,NSW,127,Kensington Central,306,76.31,95,23.69,401,99.26,3,0.74,404
1,NSW,127,Kensington Park,569,49.61,578,50.39,1147,98.88,13,1.12,1160
1,NSW,127,Kensington West,874,58.15,629,41.85,1503,99.4,9,0.6,1512
1,NSW,106,Kenthurst,589,30.77,1325,69.23,1914,99.07,18,0.93,1932
1,NSW,131,Kentlyn,217,31.91,463,68.09,680,97.7,16,2.3,696
1,NSW,135,Kentucky,46,27.06,124,72.94,170,100,0,0,170
1,NSW,130,Kew,117,28.82,289,71.18,406,98.78,5,1.22,411
1,NSW,117,Khancoban,51,22.87,172,77.13,223,99.55,1,0.45,224
1,NSW,120,Kiama,758,59.73,511,40.27,1269,98.45,20,1.55,1289
1,NSW,120,Kiama Downs,400,51.48,377,48.52,777,99.23,6,0.77,783
1,NSW,120,Kiama PPVC,3806,45.67,4528,54.33,8334,99.11,75,0.89,8409
1,NSW,120,Kiama South,206,59.71,139,40.29,345,99.14,3,0.86,348
1,NSW,126,Kilaben Bay,277,38.53,442,61.47,719,98.9,8,1.1,727
1,NSW,130,Killabakh,42,25.93,120,74.07,162,99.39,1,0.61,163
1,NSW,108,Killara,956,53.83,820,46.17,1776,99,18,1,1794
1,NSW,108,Killara East,879,49.41,900,50.59,1779,98.83,21,1.17,1800
1,NSW,151,Killarney Heights,797,56.56,612,43.44,1409,98.88,16,1.12,1425
1,NSW,115,Killarney Vale,402,38.18,651,61.82,1053,98.04,21,1.96,1074
1,NSW,115,Killarney Vale South,896,36.47,1561,63.53,2457,98.24,44,1.76,2501
1,NSW,146,Kincumber,898,46.48,1034,53.52,1932,98.62,27,1.38,1959
1,NSW,146,Kincumber Central,513,44.3,645,55.7,1158,98.97,12,1.03,1170
1,NSW,130,King Creek,128,25.2,380,74.8,508,99.41,3,0.59,511
1,NSW,149,Kings Cross (Sydney),861,77.64,248,22.36,1109,98.93,12,1.07,1121
1,NSW,152,Kings Cross (Wentworth),103,75.74,33,24.26,136,99.27,1,0.73,137
1,NSW,149,Kings Cross Central (Sydney),674,74.48,231,25.52,905,99.02,9,0.98,914
1,NSW,152,Kings Cross Central (Wentworth),408,77.27,120,22.73,528,98.32,9,1.68,537
1,NSW,149,Kings Cross SYDNEY PPVC,3478,72.44,1323,27.56,4801,99.11,43,0.89,4844
1,NSW,152,Kings Cross WENTWORTH PPVC,2606,71.24,1052,28.76,3658,99.4,22,0.6,3680
1,NSW,122,Kings Langley,818,44.14,1035,55.86,1853,99.09,17,0.91,1870
1,NSW,122,Kings Langley North,523,35.22,962,64.78,1485,99,15,1,1500
1,NSW,122,Kings Park,343,38.89,539,61.11,882,98,18,2,900
1,NSW,145,Kingscliff,610,46.78,694,53.22,1304,97.6,32,2.4,1336
1,NSW,145,Kingscliff South,406,42.2,556,57.8,962,98.06,19,1.94,981
1,NSW,127,Kingsford South,518,55.34,418,44.66,936,97.6,23,2.4,959
1,NSW,104,Kingsgrove,401,40.75,583,59.25,984,98.7,13,1.3,997
1,NSW,104,Kingsgrove North (Barton),142,35.95,253,64.05,395,98.01,8,1.99,403
1,NSW,251,Kingsgrove North (Watson),106,32.22,223,67.78,329,96.2,13,3.8,342
1,NSW,104,Kingsgrove South,543,37.6,901,62.4,1444,98.97,15,1.03,1459
1,NSW,135,Kingstown,8,13.33,52,86.67,60,100,0,0,60
1,NSW,128,Kingswood,744,42.64,1001,57.36,1745,97.81,39,2.19,1784
1,NSW,128,Kingswood North,289,40.25,429,59.75,718,98.9,8,1.1,726
1,NSW,128,Kingswood South,431,39.72,654,60.28,1085,98.46,17,1.54,1102
1,NSW,112,Kirrawee (Cook),188,53.26,165,46.74,353,97.51,9,2.49,362
1,NSW,124,Kirrawee (Hughes),736,46.88,834,53.12,1570,99.18,13,0.82,1583
1,NSW,124,Kirrawee South,614,47.86,669,52.14,1283,98.16,24,1.84,1307
1,NSW,137,Kirribilli,1289,62.42,776,37.58,2065,99.04,20,0.96,2085
1,NSW,126,Kitchener,36,9.47,344,90.53,380,97.44,10,2.56,390
1,NSW,112,Kogarah Bay,296,28.3,750,71.7,1046,98.4,17,1.6,1063
1,NSW,104,Kogarah Central,989,52.16,907,47.84,1896,98.14,36,1.86,1932
1,NSW,112,Kogarah East,233,38.64,370,61.36,603,99.18,5,0.82,608
1,NSW,104,Kogarah West,448,44.36,562,55.64,1010,98.34,17,1.66,1027
1,NSW,150,Koonawarra,357,35.17,658,64.83,1015,98.74,13,1.26,1028
1,NSW,250,Koorawatha,19,10.98,154,89.02,173,100,0,0,173
1,NSW,250,Kooringal,556,38.56,886,61.44,1442,98.36,24,1.64,1466
1,NSW,250,Kooringal North,149,35.22,274,64.78,423,98.37,7,1.63,430
1,NSW,135,Kootingal,204,19.6,837,80.4,1041,99.05,10,0.95,1051
1,NSW,118,Koraleigh,16,10.81,132,89.19,148,98.67,2,1.33,150
1,NSW,113,Korora (Cowper),387,45,473,55,860,98.85,10,1.15,870
1,NSW,138,Korora (Page),296,44.92,363,55.08,659,97.92,14,2.08,673
1,NSW,136,Kotara South (Newcastle),685,57.95,497,42.05,1182,98.83,14,1.17,1196
1,NSW,148,Kotara South (Shortland),295,61.84,182,38.16,477,99.58,2,0.42,479
1,NSW,130,Krambach,87,24.93,262,75.07,349,97.76,8,2.24,357
1,NSW,115,Kulnura,64,32,136,68,200,100,0,0,200
1,NSW,113,Kundabung,56,26.29,157,73.71,213,98.61,3,1.39,216
1,NSW,133,Kurmond,214,27.86,554,72.14,768,99.1,7,0.9,775
1,NSW,112,Kurnell,363,31.13,803,68.87,1166,98.98,12,1.02,1178
1,NSW,133,Kurrajong,412,39.02,644,60.98,1056,99.34,7,0.66,1063
1,NSW,133,Kurrajong East,109,24.22,341,75.78,450,99.12,4,0.88,454
1,NSW,133,Kurrajong North,179,27.37,475,72.63,654,99.24,5,0.76,659
1,NSW,249,Kurri Kurri,537,26.56,1485,73.44,2022,98.25,36,1.75,2058
1,NSW,126,Kurri Kurri HUNTER PPVC,244,26.9,663,73.1,907,99.02,9,0.98,916
1,NSW,249,Kurri Kurri North,171,31.09,379,68.91,550,99.1,5,0.9,555
1,NSW,249,Kurri Kurri PATERSON PPVC,1874,23.25,6186,76.75,8060,98.9,90,1.1,8150
1,NSW,104,Kyeemagh,385,35.26,707,64.74,1092,98.47,17,1.53,1109
1,NSW,138,Kyogle,488,32.43,1017,67.57,1505,98.3,26,1.7,1531
1,NSW,138,Kyogle South,184,23.26,607,76.74,791,98.38,13,1.62,804
1,NSW,127,La Perouse,904,59.51,615,40.49,1519,98.83,18,1.17,1537
1,NSW,250,Ladysmith,55,24.12,173,75.88,228,98.7,3,1.3,231
1,NSW,125,Laggan,56,21.62,203,78.38,259,99.23,2,0.77,261
1,NSW,250,Lake Albert,593,34.64,1119,65.36,1712,98.62,24,1.38,1736
1,NSW,250,Lake Albert South,67,38.95,105,61.05,172,99.42,1,0.58,173
1,NSW,139,Lake Cargelligo,206,32.14,435,67.86,641,99.07,6,0.93,647
1,NSW,130,Lake Cathie,533,37.27,897,62.73,1430,99.24,11,0.76,1441
1,NSW,120,Lake Conjola,138,37.4,231,62.6,369,99.19,3,0.81,372
1,NSW,115,Lake Haven,496,33.09,1003,66.91,1499,98.23,27,1.77,1526
1,NSW,114,Lake Heights (Cunningham),218,38.79,344,61.21,562,97.91,12,2.09,574
1,NSW,150,Lake Heights (Whitlam),128,42.95,170,57.05,298,99,3,1,301
1,NSW,150,Lake Illawarra,388,35.37,709,64.63,1097,98.56,16,1.44,1113
1,NSW,148,Lake Munmorah,535,34.61,1011,65.39,1546,98.6,22,1.4,1568
1,NSW,148,Lake Munmorah PPVC,853,29.98,1992,70.02,2845,99.16,24,0.84,2869
1,NSW,140,Lake Parramatta,448,43.66,578,56.34,1026,98.75,13,1.25,1039
1,NSW,118,Lake Wyangan,82,15.65,442,84.35,524,99.43,3,0.57,527
1,NSW,251,Lakemba,570,46.49,656,53.51,1226,97.15,36,2.85,1262
1,NSW,251,Lakemba Central,386,46.62,442,53.38,828,97.76,19,2.24,847
1,NSW,251,Lakemba North,900,65.22,480,34.78,1380,97.05,42,2.95,1422
1,NSW,122,Lalor Park,704,41.03,1012,58.97,1716,97.78,39,2.22,1755
1,NSW,122,Lalor Park North,458,41.22,653,58.78,1111,98.49,17,1.51,1128
1,NSW,136,Lambton,784,59.8,527,40.2,1311,98.79,16,1.21,1327
1,NSW,136,Lambton East,717,45.9,845,54.1,1562,98.49,24,1.51,1586
1,NSW,137,Lane Cove,654,66.94,323,33.06,977,99.09,9,0.91,986
1,NSW,137,Lane Cove East,1329,60.27,876,39.73,2205,98.61,31,1.39,2236
1,NSW,137,Lane Cove North,1584,63.16,924,36.84,2508,98.97,26,1.03,2534
1,NSW,137,Lane Cove North Central,450,60.89,289,39.11,739,99.46,4,0.54,743
1,NSW,137,Lane Cove South,773,69.14,345,30.86,1118,99.29,8,0.71,1126
1,NSW,137,Lane Cove West,1073,59.51,730,40.49,1803,99.12,16,0.88,1819
1,NSW,137,Lane Cove West Central,858,63.18,500,36.82,1358,99.34,9,0.66,1367
1,NSW,130,Lansdowne,70,18.57,307,81.43,377,98.95,4,1.05,381
1,NSW,119,Lansvale,672,49.3,691,50.7,1363,97.85,30,2.15,1393
1,NSW,119,Lansvale East,310,35.8,556,64.2,866,97.74,20,2.26,886
1,NSW,133,Lapstone,603,59.82,405,40.18,1008,99.12,9,0.88,1017
1,NSW,130,Largs,352,32.93,717,67.07,1069,99.17,9,0.83,1078
1,NSW,130,Laurieton,178,41.01,256,58.99,434,99.09,4,0.91,438
1,NSW,118,Lavington,438,30.25,1010,69.75,1448,99.11,13,0.89,1461
1,NSW,118,Lavington East,360,31.11,797,68.89,1157,98.47,18,1.53,1175
1,NSW,118,Lavington PPVC,1421,26.06,4031,73.94,5452,99.13,48,0.87,5500
1,NSW,138,Lawrence,157,26.25,441,73.75,598,99.01,6,0.99,604
1,NSW,133,Lawson,996,61.86,614,38.14,1610,98.83,19,1.17,1629
1,NSW,118,Leeton,236,28.06,605,71.94,841,98.48,13,1.52,854
1,NSW,118,Leeton North,146,30.29,336,69.71,482,98.57,7,1.43,489
1,NSW,118,Leeton Parkview,141,26.7,387,73.3,528,98.14,10,1.86,538
1,NSW,118,Leeton PPVC,614,20.64,2361,79.36,2975,98.61,42,1.39,3017
1,NSW,118,Leeton South,148,23.02,495,76.98,643,98.62,9,1.38,652
1,NSW,135,Legume,35,33.65,69,66.35,104,99.05,1,0.95,105
1,NSW,121,Leichhardt,1726,78.24,480,21.76,2206,98.7,29,1.3,2235
1,NSW,121,Leichhardt East,349,81.73,78,18.27,427,99.07,4,0.93,431
1,NSW,121,Leichhardt GRAYNDLER PPVC,8875,70.01,3802,29.99,12677,99.22,100,0.78,12777
1,NSW,144,Leichhardt REID PPVC,1026,49.02,1067,50.98,2093,99.34,14,0.66,2107
1,NSW,121,Leichhardt South,435,77.68,125,22.32,560,99.29,4,0.71,564
1,NSW,149,Leichhardt SYDNEY PPVC,795,73.34,289,26.66,1084,98.91,12,1.09,1096
1,NSW,121,Leichhardt West,958,80.71,229,19.29,1187,99.66,4,0.34,1191
1,NSW,249,Lemon Tree Passage,384,30.4,879,69.6,1263,98.98,13,1.02,1276
1,NSW,145,Lennox Head,1290,63.67,736,36.33,2026,98.78,25,1.22,2051
1,NSW,128,Leonay,412,41.24,587,58.76,999,99.21,8,0.79,1007
1,NSW,131,Leppington,399,37.05,678,62.95,1077,98.63,15,1.37,1092
1,NSW,111,Lethbridge Park,470,34.11,908,65.89,1378,97.25,39,2.75,1417
1,NSW,131,Leumeah North,608,43.03,805,56.97,1413,98.74,18,1.26,1431
1,NSW,133,Leura,523,69.36,231,30.64,754,98.69,10,1.31,764
1,NSW,133,Leura Central,366,71.35,147,28.65,513,98.84,6,1.16,519
1,NSW,121,Lewisham,1433,80.55,346,19.45,1779,98.89,20,1.11,1799
1,NSW,107,Lidcombe (Blaxland),111,50,111,50,222,99.55,1,0.45,223
1,NSW,144,Lidcombe (Reid),975,46.67,1114,53.33,2089,98.26,37,1.74,2126
1,NSW,251,Lidcombe (Watson),165,55.37,133,44.63,298,97.7,7,2.3,305
1,NSW,107,Lidcombe South (Blaxland),140,56.45,108,43.55,248,95.38,12,4.62,260
1,NSW,144,Lidcombe South (Reid),77,43.02,102,56.98,179,98.35,3,1.65,182
1,NSW,251,Lidcombe South (Watson),403,55.51,323,44.49,726,97.45,19,2.55,745
1,NSW,139,Lightning Ridge,268,26.8,732,73.2,1000,98.52,15,1.48,1015
1,NSW,139,Lightning Ridge PPVC,0,0,0,0,0,0,0,0,0
1,NSW,112,Lilli Pilli,546,41.52,769,58.48,1315,99.17,11,0.83,1326
1,NSW,121,Lilyfield,1017,77.16,301,22.84,1318,99.1,12,0.9,1330
1,NSW,121,Lilyfield North,650,77.94,184,22.06,834,99.17,7,0.83,841
1,NSW,108,Lindfield,198,53.37,173,46.63,371,98.93,4,1.07,375
1,NSW,108,Lindfield Central,224,57.44,166,42.56,390,98.98,4,1.02,394
1,NSW,108,Lindfield East,962,58.62,679,41.38,1641,99.39,10,0.61,1651
1,NSW,108,Lindfield North,1129,59.58,766,40.42,1895,99.32,13,0.68,1908
1,NSW,108,Lindfield West,1044,56.71,797,43.29,1841,99.03,18,0.97,1859
1,NSW,115,Lisarow,709,43.58,918,56.42,1627,98.43,26,1.57,1653
1,NSW,138,Lismore,264,53.55,229,46.45,493,98.6,7,1.4,500
1,NSW,138,Lismore Central,451,62.99,265,37.01,716,98.49,11,1.51,727
1,NSW,138,Lismore City,283,54.95,232,45.05,515,97.35,14,2.65,529
1,NSW,138,Lismore East,662,50.27,655,49.73,1317,98.28,23,1.72,1340
1,NSW,138,Lismore Heights,406,53.99,346,46.01,752,96.91,24,3.09,776
1,NSW,138,Lismore North,154,50.66,150,49.34,304,97.44,8,2.56,312
1,NSW,138,Lismore PAGE PPVC,3358,37.2,5670,62.8,9028,99.23,70,0.77,9098
1,NSW,145,Lismore RICHMOND PPVC,234,52.58,211,47.42,445,98.67,6,1.33,451
1,NSW,138,Lismore South,237,33.81,464,66.19,701,98.59,10,1.41,711
1,NSW,135,Liston,27,21.09,101,78.91,128,100,0,0,128
1,NSW,109,Lithgow,533,59.69,360,40.31,893,98.35,15,1.65,908
1,NSW,109,Lithgow PPVC,1732,25.23,5134,74.77,6866,99.16,58,0.84,6924
1,NSW,119,Liverpool (Fowler),628,52.86,560,47.14,1188,97.38,32,2.62,1220
1,NSW,153,Liverpool (Werriwa),82,50.31,81,49.69,163,97.02,5,2.98,168
1,NSW,119,Liverpool Central,618,40.03,926,59.97,1544,97.35,42,2.65,1586
1,NSW,119,Liverpool FOWLER PPVC,4162,48.71,4382,51.29,8544,97.61,209,2.39,8753
1,NSW,124,Liverpool HUGHES PPVC,154,44.77,190,55.23,344,98.29,6,1.71,350
1,NSW,119,Liverpool South,448,47.31,499,52.69,947,98.44,15,1.56,962
1,NSW,153,Liverpool WERRIWA PPVC,2362,43.25,3099,56.75,5461,98.41,88,1.59,5549
1,NSW,119,Liverpool West (Fowler),624,47.06,702,52.94,1326,97.29,37,2.71,1363
1,NSW,153,Liverpool West (Werriwa),122,36.42,213,63.58,335,97.67,8,2.33,343
1,NSW,128,Llandilo,206,18.8,890,81.2,1096,98.65,15,1.35,1111
1,NSW,249,Lochinvar,154,33.33,308,66.67,462,98.72,6,1.28,468
1,NSW,250,Lockhart,119,21.14,444,78.86,563,98.77,7,1.23,570
1,NSW,124,Loftus,935,53.77,804,46.23,1739,98.81,21,1.19,1760
1,NSW,128,Londonderry,250,15.75,1337,84.25,1587,98.76,20,1.24,1607
1,NSW,120,Long Beach,174,39.37,268,60.63,442,99.1,4,0.9,446
1,NSW,130,Long Flat,49,22.9,165,77.1,214,100,0,0,214
1,NSW,115,Long Jetty,319,42.14,438,57.86,757,99.47,4,0.53,761
1,NSW,115,Long Jetty East,257,49.52,262,50.48,519,97.37,14,2.63,533
1,NSW,137,Longueville,1003,60.1,666,39.9,1669,99.46,9,0.54,1678
1,NSW,135,Loomberah,5,8.47,54,91.53,59,100,0,0,59
1,NSW,149,Lord Howe Island,153,66.23,78,33.77,231,100,0,0,231
1,NSW,130,Lorn,473,53.21,416,46.79,889,99.55,4,0.45,893
1,NSW,130,Lorne,41,30.6,93,69.4,134,100,0,0,134
1,NSW,138,Lowanna,62,37.8,102,62.2,164,99.39,1,0.61,165
1,NSW,126,Lower Belford,69,27.94,178,72.06,247,99.2,2,0.8,249
1,NSW,109,Lucknow,64,32.32,134,67.68,198,99.5,1,0.5,199
1,NSW,125,Luddenham,56,13.86,348,86.14,404,98.3,7,1.7,411
1,NSW,109,Lue,12,17.91,55,82.09,67,98.53,1,1.47,68
1,NSW,103,Lugarno,690,42.46,935,57.54,1625,98.72,21,1.28,1646
1,NSW,103,Lugarno North,143,36.29,251,63.71,394,99.49,2,0.51,396
1,NSW,153,Lurnea,453,31.68,977,68.32,1430,96.23,56,3.77,1486
1,NSW,153,Lurnea South,193,33.98,375,66.02,568,95.14,29,4.86,597
1,NSW,109,Lyndhurst,25,15.43,137,84.57,162,99.39,1,0.61,163
1,NSW,113,Macksville,489,27.6,1283,72.4,1772,99.27,13,0.73,1785
1,NSW,138,Maclean,313,35.41,571,64.59,884,98.55,13,1.45,897
1,NSW,138,Maclean PPVC,1428,26.72,3916,73.28,5344,98.94,57,1.06,5401
1,NSW,153,Macquarie Fields,724,50.1,721,49.9,1445,98.1,28,1.9,1473
1,NSW,153,Macquarie Fields Central,90,40.72,131,59.28,221,99.1,2,0.9,223
1,NSW,153,Macquarie Fields East,352,40.37,520,59.63,872,96.89,28,3.11,900
1,NSW,153,Macquarie Fields North,463,47.29,516,52.71,979,98.99,10,1.01,989
1,NSW,105,Macquarie Park,990,56.9,750,43.1,1740,98.19,32,1.81,1772
1,NSW,105,Macquarie Park BENNELONG PPVC,1468,50.73,1426,49.27,2894,98.67,39,1.33,2933
1,NSW,108,Macquarie Park BRADFIELD PPVC,115,51.11,110,48.89,225,99.12,2,0.88,227
1,NSW,105,Macquarie Park South,1016,49.13,1052,50.87,2068,98.81,25,1.19,2093
1,NSW,135,Madgwick,98,60.12,65,39.88,163,99.39,1,0.61,164
1,NSW,249,Maitland,327,48.59,346,51.41,673,99.41,4,0.59,677
1,NSW,117,Majors Creek,73,44.24,92,55.76,165,98.8,2,1.2,167
1,NSW,127,Malabar,936,57.64,688,42.36,1624,98.54,24,1.46,1648
1,NSW,138,Mallanganee,46,27.38,122,72.62,168,99.41,1,0.59,169
1,NSW,120,Malua Bay,262,51.78,244,48.22,506,99.41,3,0.59,509
1,NSW,109,Mandurama,63,25.71,182,74.29,245,98.39,4,1.61,249
1,NSW,114,Mangerton,956,59.56,649,40.44,1605,99.69,5,0.31,1610
1,NSW,250,Mangoplah,31,17.13,150,82.87,181,100,0,0,181
1,NSW,146,Mangrove Mountain,97,32.77,199,67.23,296,98.67,4,1.33,300
1,NSW,109,Manildra,78,17.26,374,82.74,452,98.47,7,1.53,459
1,NSW,135,Manilla,254,18.29,1135,81.71,1389,99.43,8,0.57,1397
1,NSW,151,Manly,1419,68.82,643,31.18,2062,99.04,20,0.96,2082
1,NSW,151,Manly Central,554,68.4,256,31.6,810,98.3,14,1.7,824
1,NSW,132,Manly MACKELLAR PPVC,738,51.21,703,48.79,1441,98.7,19,1.3,1460
1,NSW,151,Manly Vale,940,62.62,561,37.38,1501,98.56,22,1.44,1523
1,NSW,151,Manly WARRINGAH PPVC,8301,59.86,5566,40.14,13867,99.29,99,0.71,13966
1,NSW,151,Manly West,1327,70.51,555,29.49,1882,99.1,17,0.9,1899
1,NSW,148,Mannering Park,326,29.06,796,70.94,1122,99.03,11,0.97,1133
1,NSW,120,Manyana,212,55.5,170,44.5,382,97.45,10,2.55,392
1,NSW,133,Maraylya,106,23.14,352,76.86,458,98.71,6,1.29,464
1,NSW,111,Marayong,646,44.04,821,55.96,1467,97.93,31,2.07,1498
1,NSW,111,Marayong Heights,344,44.56,428,55.44,772,97.97,16,2.03,788
1,NSW,111,Marayong South,346,40.19,515,59.81,861,98.97,9,1.03,870
1,NSW,111,Marayong West,670,44.64,831,55.36,1501,98.56,22,1.44,1523
1,NSW,115,Mardi,395,35.33,723,64.67,1118,98.85,13,1.15,1131
1,NSW,148,Marks Point,263,30.87,589,69.13,852,98.38,14,1.62,866
1,NSW,130,Marlee,74,33.33,148,66.67,222,99.11,2,0.89,224
1,NSW,106,Maroota,57,19.13,241,80.87,298,98.03,6,1.97,304
1,NSW,106,Maroota South,109,23.24,360,76.76,469,99.36,3,0.64,472
1,NSW,127,Maroubra,427,60.74,276,39.26,703,99.15,6,0.85,709
1,NSW,127,Maroubra Bay,854,69.94,367,30.06,1221,98.71,16,1.29,1237
1,NSW,127,Maroubra Central,749,58.61,529,41.39,1278,98.61,18,1.39,1296
1,NSW,127,Maroubra Junction,715,59.29,491,40.71,1206,98.21,22,1.79,1228
1,NSW,127,Maroubra PPVC,7817,45.21,9472,54.79,17289,98.9,192,1.1,17481
1,NSW,127,Maroubra South,1097,61.39,690,38.61,1787,98.73,23,1.27,1810
1,NSW,127,Maroubra West,769,57.09,578,42.91,1347,98.61,19,1.39,1366
1,NSW,250,Marrar,49,20.16,194,79.84,243,99.59,1,0.41,244
1,NSW,121,Marrickville,1363,75.1,452,24.9,1815,99.45,10,0.55,1825
1,NSW,104,Marrickville BARTON PPVC,2742,58.53,1943,41.47,4685,98.99,48,1.01,4733
1,NSW,121,Marrickville Central,1083,86.02,176,13.98,1259,99.45,7,0.55,1266
1,NSW,121,Marrickville East,182,74.59,62,25.41,244,100,0,0,244
1,NSW,121,Marrickville GRAYNDLER PPVC,6265,72.01,2435,27.99,8700,99.07,82,0.93,8782
1,NSW,121,Marrickville North,812,79.3,212,20.7,1024,98.65,14,1.35,1038
1,NSW,104,Marrickville Park (Barton),569,61.78,352,38.22,921,98.4,15,1.6,936
1,NSW,121,Marrickville Park (Grayndler),93,73.23,34,26.77,127,100,0,0,127
1,NSW,104,Marrickville South,578,72.8,216,27.2,794,99.13,7,0.87,801
1,NSW,149,Marrickville SYDNEY PPVC,816,69.09,365,30.91,1181,97.76,27,2.24,1208
1,NSW,251,Marrickville WATSON PPVC,274,55.02,224,44.98,498,99.4,3,0.6,501
1,NSW,104,Marrickville West (Barton),1057,73.61,379,26.39,1436,98.22,26,1.78,1462
1,NSW,121,Marrickville West (Grayndler),138,87.9,19,12.1,157,98.74,2,1.26,159
1,NSW,111,Marsden Park,1033,42.88,1376,57.12,2409,99.22,19,0.78,2428
1,NSW,111,Marsden Park Central,1847,53.29,1619,46.71,3466,99.34,23,0.66,3489
1,NSW,105,Marsfield,400,55.02,327,44.98,727,98.64,10,1.36,737
1,NSW,125,Marulan,136,20.09,541,79.91,677,98.83,8,1.17,685
1,NSW,136,Maryland,605,38.61,962,61.39,1567,98.18,29,1.82,1596
1,NSW,127,Mascot,805,50.88,777,49.12,1582,98.94,17,1.06,1599
1,NSW,127,Mascot East,689,47.68,756,52.32,1445,99.18,12,0.82,1457
1,NSW,127,Mascot North,560,53.69,483,46.31,1043,98.77,13,1.23,1056
1,NSW,118,Mathoura,83,19.67,339,80.33,422,99.06,4,0.94,426
1,NSW,127,Matraville,481,50.31,475,49.69,956,98.66,13,1.34,969
1,NSW,136,Mayfield,665,57.58,490,42.42,1155,98.47,18,1.53,1173
1,NSW,136,Mayfield East,891,70.16,379,29.84,1270,98.37,21,1.63,1291
1,NSW,136,Mayfield PPVC,3567,52.68,3204,47.32,6771,99.03,66,0.97,6837
1,NSW,136,Mayfield South,937,57.73,686,42.27,1623,98.72,21,1.28,1644
1,NSW,136,Mayfield West,436,56.4,337,43.6,773,98.22,14,1.78,787
1,NSW,133,McGraths Hill,154,26.55,426,73.45,580,98.98,6,1.02,586
1,NSW,138,Mcleans Ridges,121,52.61,109,47.39,230,98.71,3,1.29,233
1,NSW,137,McMahons Point,1104,66.63,553,33.37,1657,99.34,11,0.66,1668
1,NSW,109,Meadow Flat,49,30.25,113,69.75,162,100,0,0,162
1,NSW,105,Meadowbank,1258,61.13,800,38.87,2058,98.8,25,1.2,2083
1,NSW,249,Medowie,492,25.92,1406,74.08,1898,98.7,25,1.3,1923
1,NSW,138,Meerschaum Vale,96,39.67,146,60.33,242,99.59,1,0.41,243
1,NSW,105,Melrose Park,821,50,821,50,1642,98.98,17,1.02,1659
1,NSW,124,Menai,586,34.82,1097,65.18,1683,98.42,27,1.58,1710
1,NSW,124,Menai Central,1146,38.62,1821,61.38,2967,98.9,33,1.1,3000
1,NSW,124,Menai North,372,35.36,680,64.64,1052,99.15,9,0.85,1061
1,NSW,131,Menangle Park,48,29.45,115,70.55,163,100,0,0,163
1,NSW,139,Mendooran,45,13.64,285,86.36,330,100,0,0,330
1,NSW,139,Menindee,78,35.62,141,64.38,219,99.55,1,0.45,220
1,NSW,136,Merewether,539,58.91,376,41.09,915,99.03,9,0.97,924
1,NSW,136,Merewether Heights,757,60.85,487,39.15,1244,98.89,14,1.11,1258
1,NSW,136,Merewether South,622,59.07,431,40.93,1053,98.97,11,1.03,1064
1,NSW,117,Merimbula,216,49.77,218,50.23,434,98.19,8,1.81,442
1,NSW,117,Merimbula Central,254,49.42,260,50.58,514,98.66,7,1.34,521
1,NSW,117,Merimbula PPVC,2268,36.59,3930,63.41,6198,99.26,46,0.74,6244
1,NSW,135,Merriwa,200,22.99,670,77.01,870,98.64,12,1.36,882
1,NSW,140,Merrylands,377,27.76,981,72.24,1358,97.84,30,2.16,1388
1,NSW,315,Merrylands Central (McMahon),214,35.49,389,64.51,603,96.48,22,3.52,625
1,NSW,140,Merrylands Central (Parramatta),683,30.92,1526,69.08,2209,97.31,61,2.69,2270
1,NSW,315,Merrylands East (McMahon),553,40.51,812,59.49,1365,97.71,32,2.29,1397
1,NSW,140,Merrylands East (Parramatta),346,52.5,313,47.5,659,98.21,12,1.79,671
1,NSW,315,Merrylands South (McMahon),1333,63.27,774,36.73,2107,98.05,42,1.95,2149
1,NSW,140,Merrylands South (Parramatta),105,43.03,139,56.97,244,96.06,10,3.94,254
1,NSW,315,Merrylands West,496,36.88,849,63.12,1345,97.89,29,2.11,1374
1,NSW,249,Metford,372,30.62,843,69.38,1215,98.86,14,1.14,1229
1,NSW,117,Michelago,131,38.53,209,61.47,340,99.42,2,0.58,342
1,NSW,106,Middle Dural,252,28.47,633,71.53,885,99.55,4,0.45,889
1,NSW,153,Middleton Grange,501,33.92,976,66.08,1477,98.07,29,1.93,1506
1,NSW,126,Milbrodale,44,24.31,137,75.69,181,99.45,1,0.55,182
1,NSW,118,Mildura FARRER PPVC,134,11.49,1032,88.51,1166,99.74,3,0.26,1169
1,NSW,153,Miller,362,37.32,608,62.68,970,97,30,3,1000
1,NSW,249,Millers Forest,71,27.2,190,72.8,261,100,0,0,261
1,NSW,149,Millers Point,463,53.59,401,46.41,864,97.85,19,2.15,883
1,NSW,126,Millfield,144,27.07,388,72.93,532,99.07,5,0.93,537
1,NSW,109,Millthorpe,330,42.47,447,57.53,777,99.49,4,0.51,781
1,NSW,107,Milperra,502,31.14,1110,68.86,1612,98.77,20,1.23,1632
1,NSW,120,Milton,322,50.95,310,49.05,632,99.22,5,0.78,637
1,NSW,111,Minchinbury (Chifley),121,37.46,202,62.54,323,97.29,9,2.71,332
1,NSW,315,Minchinbury (McMahon),703,34.04,1362,65.96,2065,98.05,41,1.95,2106
1,NSW,136,Minmi,190,41.13,272,58.87,462,99.14,4,0.86,466
1,NSW,120,Minnamurra,456,54.03,388,45.97,844,99.06,8,0.94,852
1,NSW,131,Minto,780,47.45,864,52.55,1644,98.62,23,1.38,1667
1,NSW,131,Minto North,459,43.38,599,56.62,1058,98.14,20,1.86,1078
1,NSW,131,Minto South,627,44.63,778,55.37,1405,98.46,22,1.54,1427
1,NSW,112,Miranda,661,40.3,979,59.7,1640,98.56,24,1.44,1664
1,NSW,112,Miranda Central,689,42.53,931,57.47,1620,98.54,24,1.46,1644
1,NSW,112,Miranda COOK PPVC,3490,29.9,8182,70.1,11672,99.11,105,0.89,11777
1,NSW,124,Miranda HUGHES PPVC,2918,37.36,4893,62.64,7811,99.26,58,0.74,7869
1,NSW,112,Miranda North,532,39.32,821,60.68,1353,98.33,23,1.67,1376
1,NSW,112,Miranda South,182,48.92,190,51.08,372,98.67,5,1.33,377
1,NSW,113,Missabotti,38,52.05,35,47.95,73,97.33,2,2.67,75
1,NSW,130,Mitchells Island,97,24.25,303,75.75,400,99.75,1,0.25,401
1,NSW,125,Mittagong (Hume),84,41.38,119,58.62,203,99.02,2,0.98,205
1,NSW,150,Mittagong (Whitlam),793,49.44,811,50.56,1604,98.95,17,1.05,1621
1,NSW,150,Mittagong South,471,43.29,617,56.71,1088,99.09,10,0.91,1098
1,NSW,118,Moama,290,27.03,783,72.97,1073,99.08,10,0.92,1083
1,NSW,138,Modanville,138,41.32,196,58.68,334,98.82,4,1.18,338
1,NSW,120,Mogo,130,63.41,75,36.59,205,98.56,3,1.44,208
1,NSW,109,Molong,228,20.9,863,79.1,1091,98.82,13,1.18,1104
1,NSW,132,Mona Vale,1378,52.64,1240,47.36,2618,98.61,37,1.39,2655
1,NSW,132,Mona Vale North,930,50.63,907,49.37,1837,98.5,28,1.5,1865
1,NSW,132,Mona Vale PPVC,5049,43.91,6449,56.09,11498,99.19,94,0.81,11592
1,NSW,132,Mona Vale South,730,57.84,532,42.16,1262,99.14,11,0.86,1273
1,NSW,112,Monterey,431,29.28,1041,70.72,1472,98.46,23,1.54,1495
1,NSW,135,Moonbi,51,21.16,190,78.84,241,99.59,1,0.41,242
1,NSW,146,Mooney Mooney,151,56.34,117,43.66,268,99.63,1,0.37,269
1,NSW,135,Moore Creek,160,29.14,389,70.86,549,99.64,2,0.36,551
1,NSW,124,Moorebank,550,32.03,1167,67.97,1717,97.34,47,2.66,1764
1,NSW,124,Moorebank East,516,39.54,789,60.46,1305,98.71,17,1.29,1322
1,NSW,130,Moorland,61,22.02,216,77.98,277,99.64,1,0.36,278
1,NSW,139,Moree,224,23.26,739,76.74,963,98.97,10,1.03,973
1,NSW,139,Moree East,104,38.66,165,61.34,269,97.46,7,2.54,276
1,NSW,139,Moree PPVC,447,13.26,2925,86.74,3372,99.41,20,0.59,3392
1,NSW,139,Moree West,137,27.35,364,72.65,501,100,0,0,501
1,NSW,126,Morisset,445,38.07,724,61.93,1169,98.32,20,1.68,1189
1,NSW,126,Morisset Peninsula,270,35.95,481,64.05,751,99.21,6,0.79,757
1,NSW,250,Morongla Creek,11,8.46,119,91.54,130,100,0,0,130
1,NSW,249,Morpeth,453,43.1,598,56.9,1051,98.78,13,1.22,1064
1,NSW,103,Mortdale Central,714,44.24,900,55.76,1614,98.72,21,1.28,1635
1,NSW,103,Mortdale East,645,52.74,578,47.26,1223,98.71,16,1.29,1239
1,NSW,103,Mortdale PPVC,4518,37.2,7626,62.8,12144,98.86,140,1.14,12284
1,NSW,103,Mortdale West,537,40.44,791,59.56,1328,98.22,24,1.78,1352
1,NSW,144,Mortlake,663,43.82,850,56.18,1513,99.28,11,0.72,1524
1,NSW,120,Moruya,835,42.8,1116,57.2,1951,98.73,25,1.27,1976
1,NSW,120,Moruya South,242,45.57,289,54.43,531,98.33,9,1.67,540
1,NSW,151,Mosman,258,59.72,174,40.28,432,100,0,0,432
1,NSW,151,Mosman Bay,1161,66,598,34,1759,100,0,0,1759
1,NSW,151,Mosman Central,858,60.94,550,39.06,1408,99.58,6,0.42,1414
1,NSW,137,Mosman North (North Sydney),342,63.22,199,36.78,541,98.01,11,1.99,552
1,NSW,151,Mosman North (Warringah),581,59.96,388,40.04,969,99.28,7,0.72,976
1,NSW,137,Mosman NORTH SYDNEY PPVC,1115,54.05,948,45.95,2063,98.8,25,1.2,2088
1,NSW,151,Mosman WARRINGAH PPVC,5202,51.65,4870,48.35,10072,99.37,64,0.63,10136
1,NSW,150,Moss Vale,462,35.9,825,64.1,1287,99.23,10,0.77,1297
1,NSW,150,Moss Vale Central,673,41.85,935,58.15,1608,98.65,22,1.35,1630
1,NSW,118,Moulamein,40,14.87,229,85.13,269,96.76,9,3.24,278
1,NSW,125,Mount Annan,409,33.8,801,66.2,1210,98.61,17,1.39,1227
1,NSW,125,Mount Annan Central,550,34.12,1062,65.88,1612,99.26,12,0.74,1624
1,NSW,125,Mount Annan HUME PPVC,1755,25.42,5150,74.58,6905,99.08,64,0.92,6969
1,NSW,131,Mount Annan MACARTHUR PPVC,552,25.37,1624,74.63,2176,99.13,19,0.87,2195
1,NSW,250,Mount Austin,374,31.99,795,68.01,1169,98.32,20,1.68,1189
1,NSW,106,Mount Colah,1265,56.5,974,43.5,2239,98.76,28,1.24,2267
1,NSW,111,Mount Druitt,793,45.08,966,54.92,1759,95.81,77,4.19,1836
1,NSW,111,Mount Druitt CHIFLEY PPVC,7158,38.56,11406,61.44,18564,98.36,309,1.64,18873
1,NSW,128,Mount Druitt LINDSAY PPVC,429,40.09,641,59.91,1070,98.17,20,1.83,1090
1,NSW,315,Mount Druitt MCMAHON PPVC,492,34.72,925,65.28,1417,97.99,29,2.01,1446
1,NSW,111,Mount Druitt North,647,51.64,606,48.36,1253,97.74,29,2.26,1282
1,NSW,111,Mount Druitt South,506,37.76,834,62.24,1340,97.6,33,2.4,1373
1,NSW,130,Mount George,47,24.35,146,75.65,193,98.47,3,1.53,196
1,NSW,125,Mount Hunter,93,18.67,405,81.33,498,98.61,7,1.39,505
1,NSW,148,Mount Hutton,721,39.36,1111,60.64,1832,98.92,20,1.08,1852
1,NSW,114,Mount Keira,639,58.46,454,41.54,1093,98.91,12,1.09,1105
1,NSW,114,Mount Kembla,289,56.12,226,43.88,515,99.04,5,0.96,520
1,NSW,106,Mount Kuring-Gai,590,52.63,531,47.37,1121,98.77,14,1.23,1135
1,NSW,251,Mount Lewis,75,31.91,160,68.09,235,91.8,21,8.2,256
1,NSW,114,Mount Ousley,609,54.09,517,45.91,1126,98.25,20,1.75,1146
1,NSW,119,Mount Pritchard (Fowler),182,29.12,443,70.88,625,97.66,15,2.34,640
1,NSW,153,Mount Pritchard (Werriwa),66,36.87,113,63.13,179,96.76,6,3.24,185
1,NSW,119,Mount Pritchard East,445,38.7,705,61.3,1150,96.48,42,3.52,1192
1,NSW,133,Mount Riverview,693,52.74,621,47.26,1314,99.17,11,0.83,1325
1,NSW,133,Mount Victoria,243,62.79,144,37.21,387,98.22,7,1.78,394
1,NSW,150,Mount Warrigal,291,31.6,630,68.4,921,97.36,25,2.64,946
1,NSW,146,Mount White,74,49.01,77,50.99,151,99.34,1,0.66,152
1,NSW,109,Mudgee,337,29.77,795,70.23,1132,98.35,19,1.65,1151
1,NSW,109,Mudgee Central,209,31.43,456,68.57,665,97.51,17,2.49,682
1,NSW,109,Mudgee PPVC,2156,22.09,7605,77.91,9761,98.95,104,1.05,9865
1,NSW,109,Mudgee South,229,31.46,499,68.54,728,99.32,5,0.68,733
1,NSW,134,Muirfield,327,44.13,414,55.87,741,99.33,5,0.67,746
1,NSW,126,Mulbring,152,34.23,292,65.77,444,98.89,5,1.11,449
1,NSW,128,Mulgoa,166,20.8,632,79.2,798,98.4,13,1.6,811
1,NSW,139,Mullaley,20,14.6,117,85.4,137,99.28,1,0.72,138
1,NSW,138,Mullaway,472,43.58,611,56.42,1083,98.54,16,1.46,1099
1,NSW,109,Mullion Creek,80,21.68,289,78.32,369,99.19,3,0.81,372
1,NSW,145,Mullumbimby,1417,65.66,741,34.34,2158,96.9,69,3.1,2227
1,NSW,145,Mullumbimby South,456,68.47,210,31.53,666,98.52,10,1.48,676
1,NSW,118,Mulwala,179,25.21,531,74.79,710,99.02,7,0.98,717
1,NSW,109,Mumbil,29,18.83,125,81.17,154,96.25,6,3.75,160
1,NSW,139,Mungindi,47,18.15,212,81.85,259,98.85,3,1.15,262
1,NSW,118,Murray Downs,38,19.19,160,80.81,198,99,2,1,200
1,NSW,250,Murringo,40,27.21,107,72.79,147,99.32,1,0.68,148
1,NSW,117,Murrumbateman,641,47.41,711,52.59,1352,99.27,10,0.73,1362
1,NSW,250,Murrumburrah,122,22.51,420,77.49,542,98.72,7,1.28,549
1,NSW,135,Murrurundi,187,25.48,547,74.52,734,99.19,6,0.81,740
1,NSW,145,Murwillumbah,391,42,540,58,931,98.41,15,1.59,946
1,NSW,145,Murwillumbah East,283,36.56,491,63.44,774,98.47,12,1.53,786
1,NSW,145,Murwillumbah PPVC,2104,35.71,3788,64.29,5892,98.78,73,1.22,5965
1,NSW,145,Murwillumbah West,520,42.04,717,57.96,1237,98.88,14,1.12,1251
1,NSW,126,Muswellbrook,294,27.07,792,72.93,1086,98.64,15,1.36,1101
1,NSW,126,Muswellbrook East,361,26.84,984,73.16,1345,98.68,18,1.32,1363
1,NSW,126,Muswellbrook HUNTER PPVC,1011,18.22,4537,81.78,5548,99.25,42,0.75,5590
1,NSW,135,Muswellbrook NEW ENGLAND PPVC,247,14.06,1510,85.94,1757,99.15,15,0.85,1772
1,NSW,113,Mylestom,196,51.31,186,48.69,382,99.74,1,0.26,383
1,NSW,130,Nabiac,241,22.57,827,77.43,1068,98.89,12,1.11,1080
1,NSW,113,Nambucca Heads,369,38.6,587,61.4,956,97.25,27,2.75,983
1,NSW,113,Nambucca Heads PPVC,1765,29.45,4228,70.55,5993,98.89,67,1.11,6060
1,NSW,113,Nambucca Heads West,153,33.33,306,66.67,459,97.87,10,2.13,469
1,NSW,138,Nana Glen,221,33.9,431,66.1,652,98.34,11,1.66,663
1,NSW,250,Nangus,21,15.56,114,84.44,135,100,0,0,135
1,NSW,115,Narara,400,44.54,498,55.46,898,99.01,9,0.99,907
1,NSW,146,Narara South,601,47.06,676,52.94,1277,99.07,12,0.93,1289
1,NSW,125,Narellan,302,28.63,753,71.37,1055,98.88,12,1.12,1067
1,NSW,125,Narellan Vale,410,31.39,896,68.61,1306,98.49,20,1.51,1326
1,NSW,125,Narellan Vale Central,346,30.22,799,69.78,1145,99.05,11,0.95,1156
1,NSW,137,Naremburn,1321,64.47,728,35.53,2049,98.94,22,1.06,2071
1,NSW,117,Narooma,414,45.95,487,54.05,901,98.9,10,1.1,911
1,NSW,117,Narooma PPVC,1401,37.09,2376,62.91,3777,99.26,28,0.74,3805
1,NSW,132,Narrabeen,886,58.87,619,41.13,1505,98.43,24,1.57,1529
1,NSW,132,Narrabeen East,674,53.58,584,46.42,1258,98.28,22,1.72,1280
1,NSW,132,Narrabeen North,495,52.16,454,47.84,949,98.96,10,1.04,959
1,NSW,139,Narrabri,214,18.97,914,81.03,1128,98.6,16,1.4,1144
1,NSW,139,Narrabri PPVC,466,12.71,3199,87.29,3665,99.43,21,0.57,3686
1,NSW,139,Narrabri West,94,20.98,354,79.02,448,99.33,3,0.67,451
1,NSW,118,Narrandera,119,24.59,365,75.41,484,98.98,5,1.02,489
1,NSW,118,Narrandera East,141,29.75,333,70.25,474,98.75,6,1.25,480
1,NSW,118,Narrandera PPVC,405,19.88,1632,80.12,2037,98.69,27,1.31,2064
1,NSW,120,Narrawallee,366,49.19,378,50.81,744,98.67,10,1.33,754
1,NSW,132,Narraweena,1051,47.9,1143,52.1,2194,98.47,34,1.53,2228
1,NSW,132,Narraweena East,245,47.76,268,52.24,513,99.42,3,0.58,516
1,NSW,139,Narromine,369,20.59,1423,79.41,1792,96.71,61,3.29,1853
1,NSW,103,Narwee,831,39.44,1276,60.56,2107,98.73,27,1.27,2134
1,NSW,109,Nashdale,159,44.79,196,55.21,355,99.16,3,0.84,358
1,NSW,120,Nelligen,29,20.42,113,79.58,142,97.26,4,2.74,146
1,NSW,249,Nelson Bay,413,39.04,645,60.96,1058,98.51,16,1.49,1074
1,NSW,249,Nelson Bay Central,240,43.56,311,56.44,551,97.87,12,2.13,563
1,NSW,249,Nelson Bay PPVC,3387,28.31,8577,71.69,11964,99.25,90,0.75,12054
1,NSW,135,Nemingha,61,17.13,295,82.87,356,98.89,4,1.11,360
1,NSW,137,Neutral Bay (North Sydney),449,65.45,237,34.55,686,99.13,6,0.87,692
1,NSW,151,Neutral Bay (Warringah),958,64.04,538,35.96,1496,99.01,15,0.99,1511
1,NSW,151,Neutral Bay East,464,63.3,269,36.7,733,98.92,8,1.08,741
1,NSW,137,Neutral Bay West (North Sydney),292,65.91,151,34.09,443,98.88,5,1.12,448
1,NSW,151,Neutral Bay West (Warringah),310,63.92,175,36.08,485,99.39,3,0.61,488
1,NSW,136,New Lambton,1000,58.69,704,41.31,1704,98.21,31,1.79,1735
1,NSW,136,New Lambton Central,861,57.71,631,42.29,1492,99.14,13,0.86,1505
1,NSW,136,New Lambton South,873,58.47,620,41.53,1493,98.94,16,1.06,1509
1,NSW,119,Newbridge Heights,354,30.28,815,69.72,1169,98.73,15,1.27,1184
1,NSW,136,Newcastle City,985,72.91,366,27.09,1351,99.27,10,0.73,1361
1,NSW,126,Newcastle HUNTER PPVC,106,48.4,113,51.6,219,98.65,3,1.35,222
1,NSW,136,Newcastle NEWCASTLE PPVC,6007,55.81,4757,44.19,10764,99.36,69,0.64,10833
1,NSW,249,Newcastle PATERSON PPVC,195,42.58,263,57.42,458,99.35,3,0.65,461
1,NSW,148,Newcastle SHORTLAND PPVC,319,54.62,265,45.38,584,98.98,6,1.02,590
1,NSW,144,Newington,1035,49.93,1038,50.07,2073,98.57,30,1.43,2103
1,NSW,144,Newington North,552,55.65,440,44.35,992,98.8,12,1.2,1004
1,NSW,135,Newling,262,45.41,315,54.59,577,99.65,2,0.35,579
1,NSW,132,Newport,813,57.25,607,42.75,1420,98.89,16,1.11,1436
1,NSW,132,Newport Beach,925,58.88,646,41.12,1571,98.74,20,1.26,1591
1,NSW,145,Newrybar,279,65.34,148,34.66,427,98.84,5,1.16,432
1,NSW,121,Newtown East (Grayndler),413,89.59,48,10.41,461,99.35,3,0.65,464
1,NSW,149,Newtown East (Sydney),747,89.25,90,10.75,837,99.29,6,0.71,843
1,NSW,121,Newtown GRAYNDLER PPVC,2234,79.96,560,20.04,2794,99.4,17,0.6,2811
1,NSW,121,Newtown North (Grayndler),217,80.07,54,19.93,271,98.91,3,1.09,274
1,NSW,149,Newtown North (Sydney),751,80.06,187,19.94,938,99.15,8,0.85,946
1,NSW,121,Newtown South,1104,86.79,168,13.21,1272,99.14,11,0.86,1283
1,NSW,149,Newtown SYDNEY PPVC,973,78.03,274,21.97,1247,99.05,12,0.95,1259
1,NSW,115,Niagara Park (Dobell),106,44.17,134,55.83,240,96.77,8,3.23,248
1,NSW,146,Niagara Park (Robertson),725,45.71,861,54.29,1586,98.75,20,1.25,1606
1,NSW,138,Nimbin,579,65.13,310,34.87,889,96.42,33,3.58,922
1,NSW,117,Nimmitabel,39,22.94,131,77.06,170,98.84,2,1.16,172
1,NSW,115,Norah Head,115,41.67,161,58.33,276,99.64,1,0.36,277
1,NSW,148,Nords Wharf,234,39.66,356,60.34,590,98.5,9,1.5,599
1,NSW,106,Normanhurst (Berowra),448,58.64,316,41.36,764,99.09,7,0.91,771
1,NSW,108,Normanhurst (Bradfield),586,58.25,420,41.75,1006,99.21,8,0.79,1014
1,NSW,106,Normanhurst West,966,60.87,621,39.13,1587,98.69,21,1.31,1608
1,NSW,130,North Arm Cove,74,27.72,193,72.28,267,98.52,4,1.48,271
1,NSW,151,North Balgowlah,1022,65.64,535,34.36,1557,99.05,15,0.95,1572
1,NSW,113,North Boambee Valley,42,62.69,25,37.31,67,98.53,1,1.47,68
1,NSW,151,North Curl Curl,1219,63.92,688,36.08,1907,98.65,26,1.35,1933
1,NSW,130,North Haven,134,31.02,298,68.98,432,98.63,6,1.37,438
1,NSW,133,North Richmond,546,32.99,1109,67.01,1655,98.75,21,1.25,1676
1,NSW,134,North Rocks (Mitchell),561,47.83,612,52.17,1173,98.99,12,1.01,1185
1,NSW,140,North Rocks (Parramatta),648,44.26,816,55.74,1464,99.05,14,0.95,1478
1,NSW,126,North Rothbury,191,27.17,512,72.83,703,98.32,12,1.68,715
1,NSW,105,North Ryde,773,54.86,636,45.14,1409,98.19,26,1.81,1435
1,NSW,105,North Ryde Central,930,49.28,957,50.72,1887,98.69,25,1.31,1912
1,NSW,105,North Ryde Heights,328,57.95,238,42.05,566,98.61,8,1.39,574
1,NSW,139,North Star,15,12.1,109,87.9,124,99.2,1,0.8,125
1,NSW,137,North Sydney,986,69.73,428,30.27,1414,99.16,12,0.84,1426
1,NSW,108,North Wahroonga,251,56.03,197,43.97,448,99.12,4,0.88,452
1,NSW,137,Northbridge,351,63.13,205,36.87,556,99.11,5,0.89,561
1,NSW,137,Northbridge East,1060,59.12,733,40.88,1793,98.68,24,1.32,1817
1,NSW,134,Northmead (Mitchell),1070,47.2,1197,52.8,2267,99.13,20,0.87,2287
1,NSW,140,Northmead (Parramatta),320,53.69,276,46.31,596,98.19,11,1.81,607
1,NSW,134,Northmead East,427,46.41,493,53.59,920,98.29,16,1.71,936
1,NSW,134,Northmead North,380,44.55,473,55.45,853,98.5,13,1.5,866
1,NSW,135,Nowendoc,9,11.84,67,88.16,76,98.7,1,1.3,77
1,NSW,120,Nowra,486,63.12,284,36.88,770,98.47,12,1.53,782
1,NSW,120,Nowra Bomaderry,432,40.11,645,59.89,1077,98.54,16,1.46,1093
1,NSW,120,Nowra Centre,499,41.55,702,58.45,1201,98.52,18,1.48,1219
1,NSW,120,Nowra East,206,34.51,391,65.49,597,98.68,8,1.32,605
1,NSW,120,Nowra Hill,77,27.6,202,72.4,279,99.29,2,0.71,281
1,NSW,120,Nowra North,228,37.69,377,62.31,605,99.18,5,0.82,610
1,NSW,120,Nowra PPVC,4824,34.47,9172,65.53,13996,99.08,130,0.92,14126
1,NSW,120,Nowra South,357,35.81,640,64.19,997,97.46,26,2.54,1023
1,NSW,120,Nowra South PPVC,1568,24.45,4846,75.55,6414,99.13,56,0.87,6470
1,NSW,126,Nulkaba,183,35.53,332,64.47,515,99.42,3,0.58,518
1,NSW,135,Nundle,72,22.15,253,77.85,325,98.78,4,1.22,329
1,NSW,139,Nyngan,175,15.84,930,84.16,1105,98.84,13,1.16,1118
1,NSW,109,O'Connell,109,33.44,217,66.56,326,98.49,5,1.51,331
1,NSW,150,Oak Flats,590,36.83,1012,63.17,1602,98.71,21,1.29,1623
1,NSW,150,Oak Flats East,445,36,791,64,1236,98.56,18,1.44,1254
1,NSW,125,Oakdale,184,19.23,773,80.77,957,98.86,11,1.14,968
1,NSW,109,Oakey Park,62,40,93,60,155,98.73,2,1.27,157
1,NSW,111,Oakhurst,167,43.6,216,56.4,383,98.46,6,1.54,389
1,NSW,118,Oaklands,17,10.3,148,89.7,165,98.8,2,1.2,167
1,NSW,133,Oakville,145,17.64,677,82.36,822,98.8,10,1.2,832
1,NSW,140,Oatlands,690,37.48,1151,62.52,1841,98.77,23,1.23,1864
1,NSW,140,Oatlands North,241,39.31,372,60.69,613,99.35,4,0.65,617
1,NSW,103,Oatley,518,46.75,590,53.25,1108,99.02,11,0.98,1119
1,NSW,103,Oatley East,286,49.48,292,50.52,578,99.14,5,0.86,583
1,NSW,103,Oatley West,707,48.29,757,51.71,1464,99.12,13,0.88,1477
1,NSW,109,Oberon,328,18.5,1445,81.5,1773,99.49,9,0.51,1782
1,NSW,145,Ocean Shores,978,61.55,611,38.45,1589,97.72,37,2.28,1626
1,NSW,145,Ocean Shores North,527,69.25,234,30.75,761,99.09,7,0.91,768
1,NSW,130,Old Bar,522,33.29,1046,66.71,1568,98.62,22,1.38,1590
1,NSW,130,Old Bar North,61,36.75,105,63.25,166,95.95,7,4.05,173
1,NSW,140,Old Toongabbie,922,43.93,1177,56.07,2099,98.96,22,1.04,2121
1,NSW,140,Old Toongabbie North,107,45.53,128,54.47,235,98.74,3,1.26,238
1,NSW,131,Oran Park,447,38.77,706,61.23,1153,98.38,19,1.62,1172
1,NSW,125,Oran Park HUME PPVC,350,26.24,984,73.76,1334,99.33,9,0.67,1343
1,NSW,131,Oran Park MACARTHUR PPVC,3139,30.46,7166,69.54,10305,98.89,116,1.11,10421
1,NSW,131,Oran Park North,698,36.6,1209,63.4,1907,98.45,30,1.55,1937
1,NSW,131,Oran Park North West,694,36.82,1191,63.18,1885,98.38,31,1.62,1916
1,NSW,139,Orana Heights,459,28.69,1141,71.31,1600,98.04,32,1.96,1632
1,NSW,109,Orange,706,46.2,822,53.8,1528,98.71,20,1.29,1548
1,NSW,109,Orange East,476,39.4,732,60.6,1208,98.77,15,1.23,1223
1,NSW,109,Orange North,564,42.69,757,57.31,1321,98.8,16,1.2,1337
1,NSW,109,Orange North West,135,47.2,151,52.8,286,99.31,2,0.69,288
1,NSW,109,Orange PPVC,4120,26.33,11525,73.67,15645,99.23,122,0.77,15767
1,NSW,109,Orange South,249,33.97,484,66.03,733,98.92,8,1.08,741
1,NSW,109,Orange West,687,41.34,975,58.66,1662,99.05,16,0.95,1678
1,NSW,125,Orangeville,97,22.2,340,77.8,437,94.59,25,5.41,462
1,NSW,128,Orchard Hills,181,21.37,666,78.63,847,98.95,9,1.05,856
1,NSW,128,Orchard Hills West,126,31.34,276,68.66,402,98.53,6,1.47,408
1,NSW,149,Other Mobile Team 1,40,81.63,9,18.37,49,96.08,2,3.92,51
1,NSW,118,Other Mobile Team 1,65,26.21,183,73.79,248,100,0,0,248
1,NSW,250,Other Mobile Team 1,5,35.71,9,64.29,14,100,0,0,14
1,NSW,115,Ourimbah,590,40.52,866,59.48,1456,98.64,20,1.36,1476
1,NSW,128,Oxley Park,743,40.03,1113,59.97,1856,98.1,36,1.9,1892
1,NSW,135,Oxley Vale,340,28.19,866,71.81,1206,98.21,22,1.79,1228
1,NSW,124,Oyster Bay,906,52.98,804,47.02,1710,99.25,13,0.75,1723
1,NSW,124,Oyster Bay North,400,50.7,389,49.3,789,98.75,10,1.25,799
1,NSW,130,Pacific Palms,417,46.03,489,53.97,906,99.34,6,0.66,912
1,NSW,152,Paddington Central,1041,74.46,357,25.54,1398,95.36,68,4.64,1466
1,NSW,152,Paddington North,725,76,229,24,954,99.69,3,0.31,957
1,NSW,152,Paddington South,553,72.76,207,27.24,760,98.19,14,1.81,774
1,NSW,149,Paddington SYDNEY PPVC,845,72.35,323,27.65,1168,99.57,5,0.43,1173
1,NSW,152,Paddington WENTWORTH PPVC,3144,64.66,1718,35.34,4862,99.33,33,0.67,4895
1,NSW,103,Padstow,606,42.83,809,57.17,1415,98.13,27,1.87,1442
1,NSW,103,Padstow BANKS PPVC,4143,33.39,8264,66.61,12407,98.7,164,1.3,12571
1,NSW,107,Padstow BLAXLAND PPVC,592,29.94,1385,70.06,1977,98.7,26,1.3,2003
1,NSW,103,Padstow East,511,38.31,823,61.69,1334,98.02,27,1.98,1361
1,NSW,103,Padstow South,594,37.52,989,62.48,1583,98.45,25,1.55,1608
1,NSW,139,Pallamallawa,20,9.01,202,90.99,222,98.67,3,1.33,225
1,NSW,132,Palm Beach,265,54.98,217,45.02,482,98.17,9,1.83,491
1,NSW,138,Palmers Island,122,35.88,218,64.12,340,96.59,12,3.41,352
1,NSW,117,Pambula,405,49.03,421,50.97,826,99.04,8,0.96,834
1,NSW,103,Panania,371,42.89,494,57.11,865,97.85,19,2.15,884
1,NSW,103,Panania Central,411,41.81,572,58.19,983,98.6,14,1.4,997
1,NSW,103,Panania North,538,35.72,968,64.28,1506,98.62,21,1.38,1527
1,NSW,103,Panania South,709,39.88,1069,60.12,1778,98.4,29,1.6,1807
1,NSW,250,Parkes,104,21.05,390,78.95,494,99,5,1,499
1,NSW,250,Parkes East,230,21.34,848,78.66,1078,98.81,13,1.19,1091
1,NSW,250,Parkes North,124,18.84,534,81.16,658,99.25,5,0.75,663
1,NSW,250,Parkes PPVC,676,17.99,3081,82.01,3757,99.29,27,0.71,3784
1,NSW,250,Parkes South,134,20.09,533,79.91,667,97.94,14,2.06,681
1,NSW,250,Parkes West,125,24.75,380,75.25,505,99.02,5,0.98,510
1,NSW,140,Parramatta,899,55.32,726,44.68,1625,99.39,10,0.61,1635
1,NSW,107,Parramatta BLAXLAND PPVC,160,44.32,201,55.68,361,98.37,6,1.63,367
1,NSW,140,Parramatta East,770,50.33,760,49.67,1530,98.2,28,1.8,1558
1,NSW,122,Parramatta GREENWAY PPVC,294,53.65,254,46.35,548,98.74,7,1.26,555
1,NSW,315,Parramatta MCMAHON PPVC,554,42.29,756,57.71,1310,98.27,23,1.73,1333
1,NSW,134,Parramatta MITCHELL PPVC,481,43.37,628,56.63,1109,99.37,7,0.63,1116
1,NSW,140,Parramatta North,864,58.34,617,41.66,1481,97.56,37,2.44,1518
1,NSW,140,Parramatta PARRAMATTA PPVC,4880,48.13,5259,51.87,10139,98.94,109,1.06,10248
1,NSW,140,Parramatta South,1186,58.54,840,41.46,2026,99.22,16,0.78,2042
1,NSW,140,Parramatta West,787,45.97,925,54.03,1712,98.11,33,1.89,1745
1,NSW,130,Paterson Central,210,36.4,367,63.6,577,98.3,10,1.7,587
1,NSW,250,Peak Hill,161,33.97,313,66.03,474,98.34,8,1.66,482
1,NSW,103,Peakhurst East,534,38.39,857,61.61,1391,99,14,1,1405
1,NSW,103,Peakhurst South,565,41.45,798,58.55,1363,98.77,17,1.23,1380
1,NSW,103,Peakhurst West,817,41.14,1169,58.86,1986,98.27,35,1.73,2021
1,NSW,146,Peats Ridge,103,26.21,290,73.79,393,97.52,10,2.48,403
1,NSW,109,Peel,60,42.55,81,57.45,141,100,0,0,141
1,NSW,135,Peel West,255,27.3,679,72.7,934,98.63,13,1.37,947
1,NSW,249,Pelaw Main,89,32.36,186,67.64,275,98.57,4,1.43,279
1,NSW,315,Pemulwuy,819,41.59,1150,58.41,1969,98.7,26,1.3,1995
1,NSW,122,Pendle Hill (Greenway),183,47.53,202,52.47,385,98.97,4,1.03,389
1,NSW,140,Pendle Hill (Parramatta),414,50.55,405,49.45,819,98.67,11,1.33,830
1,NSW,122,Pendle Hill Central (Greenway),306,52.13,281,47.87,587,99.16,5,0.84,592
1,NSW,140,Pendle Hill Central (Parramatta),330,58.1,238,41.9,568,98.78,7,1.22,575
1,NSW,140,Pendle Hill North,682,49.6,693,50.4,1375,98.92,15,1.08,1390
1,NSW,106,Pennant Hills,1187,58.07,857,41.93,2044,94.81,112,5.19,2156
1,NSW,106,Pennant Hills BEROWRA PPVC,1815,50.35,1790,49.65,3605,98.77,45,1.23,3650
1,NSW,108,Pennant Hills BRADFIELD PPVC,442,42.58,596,57.42,1038,99.52,5,0.48,1043
1,NSW,128,Penrith,909,46.52,1045,53.48,1954,98.34,33,1.66,1987
1,NSW,111,Penrith CHIFLEY PPVC,90,36.59,156,63.41,246,99.19,2,0.81,248
1,NSW,128,Penrith East,433,48.27,464,51.73,897,98.9,10,1.1,907
1,NSW,125,Penrith HUME PPVC,79,21.12,295,78.88,374,99.47,2,0.53,376
1,NSW,128,Penrith LINDSAY PPVC,3781,28.78,9355,71.22,13136,99.02,130,0.98,13266
1,NSW,133,Penrith MACQUARIE PPVC,177,41.36,251,58.64,428,99.07,4,0.93,432
1,NSW,315,Penrith MCMAHON PPVC,112,26.29,314,73.71,426,99.3,3,0.7,429
1,NSW,128,Penrith North,421,37.29,708,62.71,1129,98.6,16,1.4,1145
1,NSW,128,Penrith South,696,36.98,1186,63.02,1882,98.9,21,1.1,1903
1,NSW,128,Penrith South Central,986,33.01,2001,66.99,2987,98.32,51,1.68,3038
1,NSW,103,Penshurst,382,41.03,549,58.97,931,98,19,2,950
1,NSW,103,Penshurst Central,701,46.39,810,53.61,1511,98.37,25,1.63,1536
1,NSW,109,Perthville,200,34.07,387,65.93,587,99.49,3,0.51,590
1,NSW,121,Petersham,812,79.69,207,20.31,1019,98.74,13,1.26,1032
1,NSW,121,Petersham East,622,82.49,132,17.51,754,99.08,7,0.92,761
1,NSW,103,Picnic Point North,446,34.39,851,65.61,1297,98.48,20,1.52,1317
1,NSW,103,Picnic Point South,42,36.52,73,63.48,115,98.29,2,1.71,117
1,NSW,125,Picton,408,31.97,868,68.03,1276,99.53,6,0.47,1282
1,NSW,139,Pilliga,20,17.86,92,82.14,112,99.12,1,0.88,113
1,NSW,133,Pitt Town,300,21.51,1095,78.49,1395,97.21,40,2.79,1435
1,NSW,136,Pittown,324,51.18,309,48.82,633,97.99,13,2.01,646
1,NSW,132,Pittwater PPVC,4380,55.34,3535,44.66,7915,99.21,63,0.79,7978
1,NSW,136,Plattsburg,612,39.16,951,60.84,1563,98.61,22,1.39,1585
1,NSW,250,Pleasant Hills,8,6.11,123,93.89,131,100,0,0,131
1,NSW,111,Plumpton,831,45.66,989,54.34,1820,97.43,48,2.57,1868
1,NSW,111,Plumpton Central,508,45.08,619,54.92,1127,98.09,22,1.91,1149
1,NSW,146,Point Clare,556,50.5,545,49.5,1101,99.19,9,0.81,1110
1,NSW,126,Pokolbin,73,32.88,149,67.12,222,98.67,3,1.33,225
1,NSW,114,Port Kembla,308,44.32,387,55.68,695,98.03,14,1.97,709
1,NSW,114,Port Kembla Central,449,45.54,537,54.46,986,98.8,12,1.2,998
1,NSW,113,Port Macquarie COWPER PPVC,3437,27.38,9114,72.62,12551,99.11,113,0.89,12664
1,NSW,113,Port Macquarie East,850,45.14,1033,54.86,1883,98.23,34,1.77,1917
1,NSW,113,Port Macquarie Greenmeadows,245,43.75,315,56.25,560,99.12,5,0.88,565
1,NSW,130,Port Macquarie LYNE PPVC,394,22.48,1359,77.52,1753,99.38,11,0.62,1764
1,NSW,113,Port Macquarie North Shore,104,37.01,177,62.99,281,98.6,4,1.4,285
1,NSW,113,Port Macquarie South,918,48.32,982,51.68,1900,97.94,40,2.06,1940
1,NSW,113,Port Macquarie Town Beach,383,40.92,553,59.08,936,98.53,14,1.47,950
1,NSW,113,Port Macquarie West,430,32.7,885,67.3,1315,97.48,34,2.52,1349
1,NSW,113,Port Macquarie West COWPER PPVC,1406,31.08,3118,68.92,4524,99.1,41,0.9,4565
1,NSW,130,Port Macquarie West LYNE PPVC,188,29.42,451,70.58,639,98.46,10,1.54,649
1,NSW,109,Portland,185,21.92,659,78.08,844,99.06,8,0.94,852
1,NSW,145,Pottsville,209,47.07,235,52.93,444,99.33,3,0.67,447
1,NSW,145,Pottsville Beach,677,47.68,743,52.32,1420,98.2,26,1.8,1446
1,NSW,153,Prestons Central,1149,39.8,1738,60.2,2887,97.7,68,2.3,2955
1,NSW,153,Prestons East,585,34.07,1132,65.93,1717,97.39,46,2.61,1763
1,NSW,153,Prestons West,209,40.82,303,59.18,512,97.52,13,2.48,525
1,NSW,150,Primbee,274,39.2,425,60.8,699,98.31,12,1.69,711
1,NSW,122,Prospect West,676,38.96,1059,61.04,1735,98.13,33,1.87,1768
1,NSW,251,Punchbowl,916,37.39,1534,62.61,2450,95.26,122,4.74,2572
1,NSW,251,Punchbowl Central,350,23.04,1169,76.96,1519,96.32,58,3.68,1577
1,NSW,251,Punchbowl East,158,40.93,228,59.07,386,95.31,19,4.69,405
1,NSW,130,Purfleet,65,53.28,57,46.72,122,100,0,0,122
1,NSW,139,Purlewaugh,18,14.4,107,85.6,125,99.21,1,0.79,126
1,NSW,105,Putney,1155,45.53,1382,54.47,2537,98.83,30,1.17,2567
1,NSW,105,Putney West,126,41.45,178,58.55,304,99.35,2,0.65,306
1,NSW,108,Pymble,706,54.35,593,45.65,1299,98.48,20,1.52,1319
1,NSW,108,Pymble North,1028,54.86,846,45.14,1874,99.57,8,0.43,1882
1,NSW,108,Pymble West,1118,61.63,696,38.37,1814,99.13,16,0.87,1830
1,NSW,149,Pyrmont,1066,57.81,778,42.19,1844,98.98,19,1.02,1863
1,NSW,149,Pyrmont South,301,65.58,158,34.42,459,99.14,4,0.86,463
1,NSW,117,Quaama,109,38.79,172,61.21,281,97.23,8,2.77,289
1,NSW,111,Quakers Hill,748,45.92,881,54.08,1629,99.09,15,0.91,1644
1,NSW,111,Quakers Hill East (Chifley),153,53.68,132,46.32,285,99.3,2,0.7,287
1,NSW,122,Quakers Hill East (Greenway),770,47.3,858,52.7,1628,99.09,15,0.91,1643
1,NSW,122,Quakers Hill North,857,47.8,936,52.2,1793,98.62,25,1.38,1818
1,NSW,122,Quakers Hill West,792,41.68,1108,58.32,1900,98.91,21,1.09,1921
1,NSW,250,Quandialla,14,9.72,130,90.28,144,99.31,1,0.69,145
1,NSW,117,Queanbeyan,482,53.14,425,46.86,907,98.37,15,1.63,922
1,NSW,117,Queanbeyan Central,402,46.47,463,53.53,865,98.52,13,1.48,878
1,NSW,117,Queanbeyan City Central,123,60,82,40,205,98.56,3,1.44,208
1,NSW,117,Queanbeyan East,604,47.67,663,52.33,1267,99.06,12,0.94,1279
1,NSW,117,Queanbeyan EDEN-MONARO PPVC,4190,37.76,6906,62.24,11096,98.99,113,1.01,11209
1,NSW,117,Queanbeyan Heights,391,47,441,53,832,98.81,10,1.19,842
1,NSW,117,Queanbeyan Heights Central,148,52.48,134,47.52,282,99.65,1,0.35,283
1,NSW,117,Queanbeyan North,321,53.06,284,46.94,605,99.34,4,0.66,609
1,NSW,117,Queanbeyan South,558,46.54,641,53.46,1199,98.04,24,1.96,1223
1,NSW,117,Queanbeyan West,591,54.98,484,45.02,1075,98.81,13,1.19,1088
1,NSW,151,Queenscliff,473,71.02,193,28.98,666,98.67,9,1.33,675
1,NSW,135,Quirindi,388,22.97,1301,77.03,1689,99.53,8,0.47,1697
1,NSW,250,RAAF Wagga Wagga PPVC,40,27.4,106,72.6,146,99.32,1,0.68,147
1,NSW,131,Raby,602,30.56,1368,69.44,1970,98.55,29,1.45,1999
1,NSW,109,Raglan,158,25.69,457,74.31,615,99.03,6,0.97,621
1,NSW,113,Raleigh,136,40.36,201,59.64,337,98.54,5,1.46,342
1,NSW,112,Ramsgate,587,34.01,1139,65.99,1726,98.52,26,1.48,1752
1,NSW,112,Ramsgate Beach,679,35.05,1258,64.95,1937,98.52,29,1.48,1966
1,NSW,127,Randwick (Kingsford Smith),653,72.8,244,27.2,897,99.34,6,0.66,903
1,NSW,152,Randwick (Wentworth),207,69.46,91,30.54,298,99,3,1,301
1,NSW,127,Randwick Central,600,64.79,326,35.21,926,98.51,14,1.49,940
1,NSW,127,Randwick East,518,67.54,249,32.46,767,98.33,13,1.67,780
1,NSW,127,Randwick KINGSFORD SMITH PPVC,5831,60.49,3809,39.51,9640,99.08,90,0.92,9730
1,NSW,127,Randwick North (Kingsford Smith),263,74.93,88,25.07,351,100,0,0,351
1,NSW,152,Randwick North (Wentworth),833,74.98,278,25.02,1111,98.14,21,1.86,1132
1,NSW,127,Randwick South,735,68.06,345,31.94,1080,97.56,27,2.44,1107
1,NSW,149,Randwick SYDNEY PPVC,462,64.44,255,35.56,717,98.76,9,1.24,726
1,NSW,152,Randwick WENTWORTH PPVC,1493,61.44,937,38.56,2430,99.06,23,0.94,2453
1,NSW,127,Randwick West,632,69.99,271,30.01,903,99.01,9,0.99,912
1,NSW,118,Rankins Springs,12,12,88,88,100,100,0,0,100
1,NSW,138,Rappville,23,22.55,79,77.45,102,100,0,0,102
1,NSW,126,Rathmines,603,37.76,994,62.24,1597,99.38,10,0.62,1607
1,NSW,249,Raymond Terrace,360,32.76,739,67.24,1099,97.86,24,2.14,1123
1,NSW,249,Raymond Terrace Central,300,30.93,670,69.07,970,97.68,23,2.32,993
1,NSW,249,Raymond Terrace East,349,28.44,878,71.56,1227,98.55,18,1.45,1245
1,NSW,130,Raymond Terrace LYNE PPVC,666,21.54,2426,78.46,3092,99.17,26,0.83,3118
1,NSW,249,Raymond Terrace North,216,29.43,518,70.57,734,96.58,26,3.42,760
1,NSW,249,Raymond Terrace PATERSON PPVC,2195,23.62,7097,76.38,9292,99.05,89,0.95,9381
1,NSW,138,Red Rock,110,44.53,137,55.47,247,99.2,2,0.8,249
1,NSW,149,Redfern,1351,77.38,395,22.62,1746,98.92,19,1.08,1765
1,NSW,149,Redfern East,814,69.63,355,30.37,1169,98.82,14,1.18,1183
1,NSW,149,Redfern West,803,75.54,260,24.46,1063,98.88,12,1.12,1075
1,NSW,148,Redhead,747,50.4,735,49.6,1482,98.41,24,1.59,1506
1,NSW,107,Regents Park,475,47.83,518,52.17,993,96.41,37,3.59,1030
1,NSW,128,Regentville,340,30.6,771,69.4,1111,98.14,21,1.86,1132
1,NSW,139,Remote Mobile Team 1,62,23.13,206,76.87,268,98.53,4,1.47,272
1,NSW,118,Remote Mobile Team 1,3,6.25,45,93.75,48,100,0,0,48
1,NSW,139,Remote Mobile Team 2,29,38.16,47,61.84,76,100,0,0,76
1,NSW,139,Remote Mobile Team 3,22,26.83,60,73.17,82,100,0,0,82
1,NSW,139,Remote Mobile Team 4,13,12.26,93,87.74,106,100,0,0,106
1,NSW,139,Remote Mobile Team 5,10,10.42,86,89.58,96,98.97,1,1.03,97
1,NSW,113,Repton,143,60.34,94,39.66,237,97.93,5,2.07,242
1,NSW,103,Revesby,507,38.47,811,61.53,1318,97.99,27,2.01,1345
1,NSW,103,Revesby North (Banks),553,38.64,878,61.36,1431,97.28,40,2.72,1471
1,NSW,107,Revesby North (Blaxland),102,37.23,172,62.77,274,98.92,3,1.08,277
1,NSW,103,Revesby South,662,36.53,1150,63.47,1812,98.26,32,1.74,1844
1,NSW,144,Rhodes,866,49.12,897,50.88,1763,99.1,16,0.9,1779
1,NSW,133,Richmond,464,35.39,847,64.61,1311,98.5,20,1.5,1331
1,NSW,128,Richmond LINDSAY PPVC,178,16.42,906,83.58,1084,98.81,13,1.19,1097
1,NSW,133,Richmond MACQUARIE PPVC,2606,25.58,7583,74.42,10189,99.09,94,0.91,10283
1,NSW,122,Riverstone,636,36.51,1106,63.49,1742,99.26,13,0.74,1755
1,NSW,122,Riverstone East,992,43.15,1307,56.85,2299,99.05,22,0.95,2321
1,NSW,103,Riverwood East (Banks),410,38.97,642,61.03,1052,97.23,30,2.77,1082
1,NSW,251,Riverwood East (Watson),159,30.75,358,69.25,517,98.1,10,1.9,527
1,NSW,103,Riverwood North,366,38.41,587,61.59,953,96.65,33,3.35,986
1,NSW,103,Riverwood South,409,36.23,720,63.77,1129,99.21,9,0.79,1138
1,NSW,150,Robertson,445,47.44,493,52.56,938,99.15,8,0.85,946
1,NSW,104,Rockdale,442,40.4,652,59.6,1094,98.03,22,1.97,1116
1,NSW,104,Rockdale BARTON PPVC,4420,40.55,6481,59.45,10901,98.51,165,1.49,11066
1,NSW,104,Rockdale Central,796,51.72,743,48.28,1539,98.59,22,1.41,1561
1,NSW,104,Rockdale City,221,51.4,209,48.6,430,98.62,6,1.38,436
1,NSW,112,Rockdale COOK PPVC,897,32.57,1857,67.43,2754,99.06,26,0.94,2780
1,NSW,104,Rockdale West,449,46.67,513,53.33,962,98.77,12,1.23,974
1,NSW,109,Rockley,24,16.22,124,83.78,148,99.33,1,0.67,149
1,NSW,135,Rocky River,110,32.26,231,67.74,341,98.27,6,1.73,347
1,NSW,106,Rogans Hill North,1118,47.8,1221,52.2,2339,99.49,12,0.51,2351
1,NSW,130,Rollands Plains,46,24.34,143,75.66,189,99.47,1,0.53,190
1,NSW,111,Rooty Hill North,637,42.44,864,57.56,1501,98.04,30,1.96,1531
1,NSW,111,Rooty Hill South,767,38.06,1248,61.94,2015,98.92,22,1.08,2037
1,NSW,111,Rooty Hill West,196,41.79,273,58.21,469,98.95,5,1.05,474
1,NSW,111,Ropes Crossing,1023,44.77,1262,55.23,2285,97.98,47,2.02,2332
1,NSW,152,Rose Bay,1049,57.7,769,42.3,1818,99.02,18,0.98,1836
1,NSW,152,Rose Bay Central,719,51.32,682,48.68,1401,99.08,13,0.92,1414
1,NSW,152,Rose Bay PPVC,1728,56.8,1314,43.2,3042,98.86,35,1.14,3077
1,NSW,138,Rosebank,126,68.11,59,31.89,185,99.46,1,0.54,186
1,NSW,149,Rosebery,763,68.13,357,31.88,1120,98.85,13,1.15,1133
1,NSW,127,Rosebery West (Kingsford Smith),313,58.95,218,41.05,531,98.7,7,1.3,538
1,NSW,149,Rosebery West (Sydney),570,64.33,316,35.67,886,98.66,12,1.34,898
1,NSW,140,Rosehill,857,46.65,980,53.35,1837,97.87,40,2.13,1877
1,NSW,251,Roselands,856,32.24,1799,67.76,2655,97.36,72,2.64,2727
1,NSW,131,Rosemeadow,798,36.56,1385,63.44,2183,98.42,35,1.58,2218
1,NSW,131,Rosemeadow East,65,34.39,124,65.61,189,98.44,3,1.56,192
1,NSW,108,Roseville,757,58.28,542,41.72,1299,99.46,7,0.54,1306
1,NSW,108,Roseville East,636,57.19,476,42.81,1112,99.11,10,0.89,1122
1,NSW,108,Roseville South,470,54.59,391,45.41,861,99.42,5,0.58,866
1,NSW,117,Rosewood,23,13.53,147,86.47,170,100,0,0,170
1,NSW,135,Ross Hill,156,19,665,81,821,98.92,9,1.08,830
1,NSW,131,Rossmore (Macarthur),64,17.98,292,82.02,356,98.61,5,1.39,361
1,NSW,153,Rossmore (Werriwa),105,19.52,433,80.48,538,98,11,2,549
1,NSW,138,Rous,219,40.71,319,59.29,538,99.26,4,0.74,542
1,NSW,134,Rouse Hill,833,36.54,1447,63.46,2280,99.26,17,0.74,2297
1,NSW,134,Rouse Hill PPVC,1925,36.52,3346,63.48,5271,99.58,22,0.42,5293
1,NSW,134,Rouse Hill South,1476,43.79,1895,56.21,3371,98.51,51,1.49,3422
1,NSW,121,Rozelle,1466,79.5,378,20.5,1844,99.35,12,0.65,1856
1,NSW,121,Rozelle Central,879,70.55,367,29.45,1246,99.2,10,0.8,1256
1,NSW,121,Rozelle East,491,74.28,170,25.72,661,98.66,9,1.34,670
1,NSW,131,Ruse,632,30.78,1421,69.22,2053,98,42,2,2095
1,NSW,144,Russell Lea,630,55.26,510,44.74,1140,98.45,18,1.55,1158
1,NSW,114,Russell Vale,470,49.06,488,50.94,958,99.27,7,0.73,965
1,NSW,249,Rutherford,276,36.85,473,63.15,749,98.17,14,1.83,763
1,NSW,126,Rutherford HUNTER PPVC,186,23.02,622,76.98,808,99.02,8,0.98,816
1,NSW,130,Rutherford LYNE PPVC,203,29.68,481,70.32,684,99.71,2,0.29,686
1,NSW,249,Rutherford North,665,29.9,1559,70.1,2224,98.41,36,1.59,2260
1,NSW,249,Rutherford PATERSON PPVC,2085,24.26,6511,75.74,8596,99.19,70,0.81,8666
1,NSW,249,Rutherford West,313,30.51,713,69.49,1026,98.46,16,1.54,1042
1,NSW,140,Rydalmere,668,48.34,714,51.66,1382,98.64,19,1.36,1401
1,NSW,105,Ryde,283,51.08,271,48.92,554,98.05,11,1.95,565
1,NSW,105,Ryde Central,550,48.42,586,51.58,1136,98.35,19,1.65,1155
1,NSW,105,Ryde Heights,707,45.76,838,54.24,1545,98.66,21,1.34,1566
1,NSW,105,Ryde South,237,58.96,165,41.04,402,99.5,2,0.5,404
1,NSW,125,Rye Park,30,23.44,98,76.56,128,99.22,1,0.78,129
1,NSW,109,Rylstone,197,28.02,506,71.98,703,98.46,11,1.54,714
1,NSW,153,Sadleir,278,35.64,502,64.36,780,97.99,16,2.01,796
1,NSW,249,Salamander,204,39.84,308,60.16,512,99.22,4,0.78,516
1,NSW,249,Salamander Bay,291,32.88,594,67.12,885,98.88,10,1.12,895
1,NSW,249,Salt Ash,156,22.91,525,77.09,681,99.71,2,0.29,683
1,NSW,148,San Remo,390,28.93,958,71.07,1348,98.47,21,1.53,1369
1,NSW,120,Sanctuary Point,497,34.35,950,65.65,1447,98.37,24,1.63,1471
1,NSW,112,Sandringham,661,31.61,1430,68.39,2091,98.45,33,1.55,2124
1,NSW,138,Sandy Beach,896,45.23,1085,54.77,1981,98.12,38,1.88,2019
1,NSW,126,Sandy Hollow,40,19.51,165,80.49,205,99.51,1,0.49,206
1,NSW,112,Sans Souci,661,32.12,1397,67.88,2058,98.47,32,1.53,2090
1,NSW,146,Saratoga,633,43.27,830,56.73,1463,99.32,10,0.68,1473
1,NSW,113,Sawtell,563,52.52,509,47.48,1072,99.17,9,0.83,1081
1,NSW,111,Schofields (Chifley),305,42.07,420,57.93,725,98.37,12,1.63,737
1,NSW,122,Schofields (Greenway),942,46,1106,54,2048,98.75,26,1.25,2074
1,NSW,111,Schofields CHIFLEY PPVC,2095,39.53,3205,60.47,5300,99.07,50,0.93,5350
1,NSW,122,Schofields GREENWAY PPVC,2421,39.79,3663,60.21,6084,98.81,73,1.19,6157
1,NSW,134,Schofields MITCHELL PPVC,75,38.66,119,61.34,194,99.49,1,0.51,195
1,NSW,122,Schofields South,558,47.86,608,52.14,1166,99.49,6,0.51,1172
1,NSW,135,Scone,342,23.47,1115,76.53,1457,99.18,12,0.82,1469
1,NSW,135,Scone East,174,22.42,602,77.58,776,98.73,10,1.27,786
1,NSW,135,Scone South,227,24.02,718,75.98,945,99.26,7,0.74,952
1,NSW,113,Scotts Head,252,47.82,275,52.18,527,97.41,14,2.59,541
1,NSW,151,Seaforth,1138,61.58,710,38.42,1848,98.67,25,1.33,1873
1,NSW,130,Seaham,226,29.97,528,70.03,754,98.95,8,1.05,762
1,NSW,107,Sefton,644,39.63,981,60.37,1625,99.09,15,0.91,1640
1,NSW,113,Settlement Shores,554,39.37,853,60.63,1407,98.25,25,1.75,1432
1,NSW,122,Seven Hills,450,48.08,486,51.92,936,97.81,21,2.19,957
1,NSW,122,Seven Hills Central,509,46.36,589,53.64,1098,98.39,18,1.61,1116
1,NSW,122,Seven Hills East,472,42.71,633,57.29,1105,97.96,23,2.04,1128
1,NSW,122,Seven Hills Heights,551,48.25,591,51.75,1142,98.19,21,1.81,1163
1,NSW,122,Seven Hills North,553,46.82,628,53.18,1181,98.75,15,1.25,1196
1,NSW,122,Seven Hills South,723,42.16,992,57.84,1715,99.19,14,0.81,1729
1,NSW,122,Seven Hills West,716,45.17,869,54.83,1585,98.51,24,1.49,1609
1,NSW,111,Shalvey,299,31.91,638,68.09,937,98.12,18,1.88,955
1,NSW,150,Shell Cove,777,40.7,1132,59.3,1909,98.96,20,1.04,1929
1,NSW,150,Shellharbour,669,42.5,905,57.5,1574,98.81,19,1.19,1593
1,NSW,115,Shelly Beach,614,41.43,868,58.57,1482,98.28,26,1.72,1508
1,NSW,249,Shoal Bay,243,41.05,349,58.95,592,99.33,4,0.67,596
1,NSW,120,Shoalhaven Heads,568,40.83,823,59.17,1391,98.86,16,1.14,1407
1,NSW,136,Shortland,590,45.77,699,54.23,1289,98.7,17,1.3,1306
1,NSW,125,Silverdale,91,18.02,414,81.98,505,99.21,4,0.79,509
1,NSW,107,Silverwater (Blaxland),114,50.89,110,49.11,224,95.73,10,4.27,234
1,NSW,144,Silverwater (Reid),181,42.09,249,57.91,430,97.73,10,2.27,440
1,NSW,126,Singleton,186,27.07,501,72.93,687,99.57,3,0.43,690
1,NSW,126,Singleton Heights,451,25.45,1321,74.55,1772,98.17,33,1.83,1805
1,NSW,126,Singleton PPVC,1641,20.08,6531,79.92,8172,99.05,78,0.95,8250
1,NSW,126,Singleton South,374,26.51,1037,73.49,1411,98.81,17,1.19,1428
1,NSW,145,Skennars Head,203,57.83,148,42.17,351,98.87,4,1.13,355
1,NSW,131,Smeaton Grange,18,35.29,33,64.71,51,100,0,0,51
1,NSW,315,Smithfield,459,33.5,911,66.5,1370,98.35,23,1.65,1393
1,NSW,119,Smithfield West (Fowler),53,26.9,144,73.1,197,99.49,1,0.51,198
1,NSW,315,Smithfield West (McMahon),327,28.94,803,71.06,1130,97.84,25,2.16,1155
1,NSW,249,Soldiers Point,258,42.86,344,57.14,602,99.18,5,0.82,607
1,NSW,146,Somersby,166,29.54,396,70.46,562,98.6,8,1.4,570
1,NSW,249,Somerset,436,30.68,985,69.32,1421,98.54,21,1.46,1442
1,NSW,135,Somerton,27,16.98,132,83.02,159,98.76,2,1.24,161
1,NSW,120,South Durras,77,50.99,74,49.01,151,100,0,0,151
1,NSW,138,South Grafton,414,24.81,1255,75.19,1669,99.17,14,0.83,1683
1,NSW,138,South Grafton Central,217,22.05,767,77.95,984,98.7,13,1.3,997
1,NSW,108,South Turramurra,584,64.6,320,35.4,904,99.01,9,0.99,913
1,NSW,108,South Turramurra Heights,1390,61.53,869,38.47,2259,98.95,24,1.05,2283
1,NSW,315,South Wentworthville Central,332,33.37,663,66.63,995,98.51,15,1.49,1010
1,NSW,113,South West Rocks,198,32.73,407,67.27,605,99.02,6,0.98,611
1,NSW,113,South West Rocks PPVC,697,24.7,2125,75.3,2822,99.09,26,0.91,2848
1,NSW,113,South West Rocks South,132,31.5,287,68.5,419,98.82,5,1.18,424
1,NSW,249,Special Hospital Team 1,96,38.71,152,61.29,248,99.2,2,0.8,250
1,NSW,105,Special Hospital Team 1,80,62.02,49,37.98,129,96.27,5,3.73,134
1,NSW,106,Special Hospital Team 1,101,52.88,90,47.12,191,96.46,7,3.54,198
1,NSW,108,Special Hospital Team 1,240,46.6,275,53.4,515,98.85,6,1.15,521
1,NSW,113,Special Hospital Team 1,72,35.82,129,64.18,201,98.53,3,1.47,204
1,NSW,115,Special Hospital Team 1,104,52.26,95,47.74,199,97.55,5,2.45,204
1,NSW,119,Special Hospital Team 1,67,31.6,145,68.4,212,97.7,5,2.3,217
1,NSW,125,Special Hospital Team 1,150,38.76,237,61.24,387,97.48,10,2.52,397
1,NSW,135,Special Hospital Team 1,47,45.19,57,54.81,104,96.3,4,3.7,108
1,NSW,137,Special Hospital Team 1,209,66.14,107,33.86,316,97.53,8,2.47,324
1,NSW,145,Special Hospital Team 1,92,50.83,89,49.17,181,98.37,3,1.63,184
1,NSW,152,Special Hospital Team 1,202,56.9,153,43.1,355,98.61,5,1.39,360
1,NSW,134,Special Hospital Team 1,95,50.26,94,49.74,189,98.44,3,1.56,192
1,NSW,139,Special Hospital Team 1,79,31.98,168,68.02,247,91.14,24,8.86,271
1,NSW,107,Special Hospital Team 1,24,41.38,34,58.62,58,100,0,0,58
1,NSW,315,Special Hospital Team 1,78,48.45,83,51.55,161,98.17,3,1.83,164
1,NSW,251,Special Hospital Team 1,187,59.74,126,40.26,313,97.51,8,2.49,321
1,NSW,130,Special Hospital Team 1,51,40.48,75,59.52,126,99.21,1,0.79,127
1,NSW,146,Special Hospital Team 1,68,57.14,51,42.86,119,97.54,3,2.46,122
1,NSW,109,Special Hospital Team 1,125,46.99,141,53.01,266,96.73,9,3.27,275
1,NSW,144,Special Hospital Team 1,87,56.86,66,43.14,153,96.23,6,3.77,159
1,NSW,114,Special Hospital Team 1,75,58.14,54,41.86,129,96.99,4,3.01,133
1,NSW,120,Special Hospital Team 1,78,46.43,90,53.57,168,100,0,0,168
1,NSW,150,Special Hospital Team 1,109,45.61,130,54.39,239,99.58,1,0.42,240
1,NSW,138,Special Hospital Team 1,50,56.18,39,43.82,89,100,0,0,89
1,NSW,111,Special Hospital Team 1,77,60.16,51,39.84,128,94.12,8,5.88,136
1,NSW,118,Special Hospital Team 1,91,41.18,130,58.82,221,89.47,26,10.53,247
1,NSW,126,Special Hospital Team 1,78,35.45,142,64.55,220,97.78,5,2.22,225
1,NSW,112,Special Hospital Team 1,87,58.39,62,41.61,149,98.68,2,1.32,151
1,NSW,124,Special Hospital Team 1,105,51.47,99,48.53,204,99.51,1,0.49,205
1,NSW,250,Special Hospital Team 1,57,33.53,113,66.47,170,89.95,19,10.05,189
1,NSW,104,Special Hospital Team 1,53,63.86,30,36.14,83,97.65,2,2.35,85
1,NSW,127,Special Hospital Team 1,106,58.89,74,41.11,180,98.9,2,1.1,182
1,NSW,149,Special Hospital Team 1,28,71.79,11,28.21,39,92.86,3,7.14,42
1,NSW,153,Special Hospital Team 1,31,53.45,27,46.55,58,92.06,5,7.94,63
1,NSW,103,Special Hospital Team 1,71,52.59,64,47.41,135,97.83,3,2.17,138
1,NSW,122,Special Hospital Team 1,55,45.08,67,54.92,122,99.19,1,0.81,123
1,NSW,128,Special Hospital Team 1,63,50.4,62,49.6,125,88.65,16,11.35,141
1,NSW,117,Special Hospital Team 1,50,42.37,68,57.63,118,95.16,6,4.84,124
1,NSW,133,Special Hospital Team 1,117,65.36,62,34.64,179,97.81,4,2.19,183
1,NSW,121,Special Hospital Team 1,62,74.7,21,25.3,83,97.65,2,2.35,85
1,NSW,148,Special Hospital Team 1,62,55.86,49,44.14,111,96.52,4,3.48,115
1,NSW,140,Special Hospital Team 1,55,53.4,48,46.6,103,99.04,1,0.96,104
1,NSW,136,Special Hospital Team 1,79,52.67,71,47.33,150,97.4,4,2.6,154
1,NSW,132,Special Hospital Team 1,90,46.88,102,53.13,192,100,0,0,192
1,NSW,151,Special Hospital Team 1,45,69.23,20,30.77,65,100,0,0,65
1,NSW,131,Special Hospital Team 1,74,61.67,46,38.33,120,96.77,4,3.23,124
1,NSW,139,Special Hospital Team 2,63,31.98,134,68.02,197,100,0,0,197
1,NSW,113,Special Hospital Team 2,96,43.84,123,56.16,219,96.9,7,3.1,226
1,NSW,109,Special Hospital Team 2,71,36.79,122,63.21,193,99.48,1,0.52,194
1,NSW,120,Special Hospital Team 2,83,45.11,101,54.89,184,98.92,2,1.08,186
1,NSW,145,Special Hospital Team 2,65,40.63,95,59.38,160,98.16,3,1.84,163
1,NSW,112,Special Hospital Team 2,53,44.17,67,55.83,120,97.56,3,2.44,123
1,NSW,115,Special Hospital Team 2,67,43.23,88,56.77,155,98.73,2,1.27,157
1,NSW,114,Special Hospital Team 2,79,58.96,55,41.04,134,99.26,1,0.74,135
1,NSW,150,Special Hospital Team 2,126,42.57,170,57.43,296,97.37,8,2.63,304
1,NSW,103,Special Hospital Team 2,62,47.33,69,52.67,131,97.04,4,2.96,135
1,NSW,128,Special Hospital Team 2,64,43.24,84,56.76,148,96.1,6,3.9,154
1,NSW,105,Special Hospital Team 2,64,60.38,42,39.62,106,97.25,3,2.75,109
1,NSW,124,Special Hospital Team 2,45,44.55,56,55.45,101,98.06,2,1.94,103
1,NSW,117,Special Hospital Team 2,83,54.61,69,45.39,152,100,0,0,152
1,NSW,104,Special Hospital Team 2,24,52.17,22,47.83,46,88.46,6,11.54,52
1,NSW,133,Special Hospital Team 2,55,45.45,66,54.55,121,95.28,6,4.72,127
1,NSW,130,Special Hospital Team 2,73,36.14,129,63.86,202,95.28,10,4.72,212
1,NSW,106,Special Hospital Team 2,100,58.82,70,41.18,170,90.43,18,9.57,188
1,NSW,118,Special Hospital Team 2,55,33.74,108,66.26,163,97.6,4,2.4,167
1,NSW,121,Special Hospital Team 2,56,82.35,12,17.65,68,90.67,7,9.33,75
1,NSW,108,Special Hospital Team 2,116,56.31,90,43.69,206,94.5,12,5.5,218
1,NSW,137,Special Hospital Team 2,84,64.12,47,35.88,131,97.04,4,2.96,135
1,NSW,127,Special Hospital Team 2,86,62.77,51,37.23,137,95.8,6,4.2,143
1,NSW,152,Special Hospital Team 2,87,65.41,46,34.59,133,97.79,3,2.21,136
1,NSW,136,Special Hospital Team 2,64,43.54,83,56.46,147,96.08,6,3.92,153
1,NSW,132,Special Hospital Team 2,69,48.25,74,51.75,143,97.95,3,2.05,146
1,NSW,151,Special Hospital Team 2,30,62.5,18,37.5,48,100,0,0,48
1,NSW,125,Special Hospital Team 2,68,48.57,72,51.43,140,98.59,2,1.41,142
1,NSW,126,Special Hospital Team 2,54,36.49,94,63.51,148,99.33,1,0.67,149
1,NSW,138,Special Hospital Team 2,53,44.92,65,55.08,118,99.16,1,0.84,119
1,NSW,135,Special Hospital Team 2,55,41.98,76,58.02,131,92.91,10,7.09,141
1,NSW,146,Special Hospital Team 2,114,62.3,69,37.7,183,96.83,6,3.17,189
1,NSW,153,Special Hospital Team 2,31,50,31,50,62,95.38,3,4.62,65
1,NSW,250,Special Hospital Team 2,38,22.35,132,77.65,170,98.27,3,1.73,173
1,NSW,249,Special Hospital Team 2,64,43.54,83,56.46,147,96.08,6,3.92,153
1,NSW,115,Special Hospital Team 3,138,48.59,146,51.41,284,99.3,2,0.7,286
1,NSW,120,Special Hospital Team 3,70,41.67,98,58.33,168,100,0,0,168
1,NSW,109,Special Hospital Team 3,39,39,61,61,100,100,0,0,100
1,NSW,139,Special Hospital Team 3,59,27.83,153,72.17,212,99.53,1,0.47,213
1,NSW,117,Special Hospital Team 3,45,54.22,38,45.78,83,97.65,2,2.35,85
1,NSW,104,Special Hospital Team 3,61,54.46,51,45.54,112,98.25,2,1.75,114
1,NSW,145,Special Hospital Team 3,52,58.43,37,41.57,89,98.89,1,1.11,90
1,NSW,130,Special Hospital Team 3,87,54.04,74,45.96,161,98.77,2,1.23,163
1,NSW,118,Special Hospital Team 3,26,36.11,46,63.89,72,100,0,0,72
1,NSW,136,Special Hospital Team 3,79,64.23,44,35.77,123,96.85,4,3.15,127
1,NSW,132,Special Hospital Team 3,225,37.07,382,62.93,607,99.35,4,0.65,611
1,NSW,151,Special Hospital Team 3,17,48.57,18,51.43,35,92.11,3,7.89,38
1,NSW,138,Special Hospital Team 3,68,51.52,64,48.48,132,99.25,1,0.75,133
1,NSW,146,Special Hospital Team 3,128,52.67,115,47.33,243,92.4,20,7.6,263
1,NSW,113,Special Hospital Team 3,69,43.4,90,56.6,159,99.38,1,0.63,160
1,NSW,250,Special Hospital Team 3,108,48.21,116,51.79,224,96.97,7,3.03,231
1,NSW,135,Special Hospital Team 3,36,44.44,45,55.56,81,91.01,8,8.99,89
1,NSW,126,Special Hospital Team 3,57,51.35,54,48.65,111,95.69,5,4.31,116
1,NSW,115,Special Hospital Team 4,107,56.02,84,43.98,191,93.17,14,6.83,205
1,NSW,120,Special Hospital Team 4,19,54.29,16,45.71,35,100,0,0,35
1,NSW,109,Special Hospital Team 4,116,43.45,151,56.55,267,96.74,9,3.26,276
1,NSW,139,Special Hospital Team 4,41,56.94,31,43.06,72,91.14,7,8.86,79
1,NSW,117,Special Hospital Team 4,89,45.88,105,54.12,194,98.98,2,1.02,196
1,NSW,145,Special Hospital Team 4,124,46.27,144,53.73,268,85.9,44,14.1,312
1,NSW,130,Special Hospital Team 4,26,35.62,47,64.38,73,98.65,1,1.35,74
1,NSW,118,Special Hospital Team 4,53,38.69,84,61.31,137,95.14,7,4.86,144
1,NSW,138,Special Hospital Team 4,50,43.86,64,56.14,114,93.44,8,6.56,122
1,NSW,113,Special Hospital Team 4,77,34.07,149,65.93,226,97.41,6,2.59,232
1,NSW,250,Special Hospital Team 4,79,41.15,113,58.85,192,98.97,2,1.03,194
1,NSW,135,Special Hospital Team 4,42,47.19,47,52.81,89,94.68,5,5.32,94
1,NSW,120,Special Hospital Team 5,68,50.37,67,49.63,135,100,0,0,135
1,NSW,109,Special Hospital Team 5,53,37.59,88,62.41,141,95.92,6,4.08,147
1,NSW,145,Special Hospital Team 5,58,40.56,85,59.44,143,99.31,1,0.69,144
1,NSW,118,Special Hospital Team 5,26,30.59,59,69.41,85,95.51,4,4.49,89
1,NSW,113,Special Hospital Team 5,90,37.82,148,62.18,238,99.17,2,0.83,240
1,NSW,135,Special Hospital Team 5,14,34.15,27,65.85,41,100,0,0,41
1,NSW,118,Special Hospital Team 6,25,44.64,31,55.36,56,98.25,1,1.75,57
1,NSW,113,Special Hospital Team 6,64,42.95,85,57.05,149,95.51,7,4.49,156
1,NSW,118,Special Hospital Team 7,1,25,3,75,4,100,0,0,4
1,NSW,148,Speers Point,699,40.73,1017,59.27,1716,98.79,21,1.21,1737
1,NSW,146,Spencer,62,38.99,97,61.01,159,99.38,1,0.63,160
1,NSW,151,Spit Junction,791,57.57,583,42.43,1374,96.97,43,3.03,1417
1,NSW,125,Spring Farm,768,31.93,1637,68.07,2405,98.57,35,1.43,2440
1,NSW,109,Spring Hill,84,28.67,209,71.33,293,99.66,1,0.34,294
1,NSW,135,Spring Ridge,20,12.66,138,87.34,158,98.14,3,1.86,161
1,NSW,109,Spring Terrace,67,29.91,157,70.09,224,99.56,1,0.44,225
1,NSW,118,Springdale Heights,172,35.46,313,64.54,485,99.39,3,0.61,488
1,NSW,146,Springfield,575,49.65,583,50.35,1158,99.4,7,0.6,1165
1,NSW,133,Springwood,493,66.09,253,33.91,746,99.2,6,0.8,752
1,NSW,133,Springwood North,713,51.26,678,48.74,1391,98.79,17,1.21,1408
1,NSW,133,Springwood PPVC,5422,49.58,5513,50.42,10935,99.07,103,0.93,11038
1,NSW,133,Springwood South,604,59.74,407,40.26,1011,99.31,7,0.69,1018
1,NSW,133,St Albans,77,48.73,81,51.27,158,98.14,3,1.86,161
1,NSW,131,St Andrews,649,36.22,1143,63.78,1792,98.19,33,1.81,1825
1,NSW,131,St Andrews South,398,31.14,880,68.86,1278,97.93,27,2.07,1305
1,NSW,315,St Clair,347,31.72,747,68.28,1094,98.2,20,1.8,1114
1,NSW,315,St Clair East,508,31.55,1102,68.45,1610,98.11,31,1.89,1641
1,NSW,315,St Clair South,1315,69.8,569,30.2,1884,98.28,33,1.72,1917
1,NSW,315,St Clair South West,77,35.81,138,64.19,215,98.17,4,1.83,219
1,NSW,315,St Clair West,759,33.2,1527,66.8,2286,98.32,39,1.68,2325
1,NSW,120,St Georges Basin,291,32.3,610,67.7,901,98.79,11,1.21,912
1,NSW,131,St Helens Park,494,34.28,947,65.72,1441,98.5,22,1.5,1463
1,NSW,131,St Helens Park North,431,34.84,806,65.16,1237,98.88,14,1.12,1251
1,NSW,108,St Ives,790,47.31,880,52.69,1670,99.23,13,0.77,1683
1,NSW,108,St Ives Chase,425,49.02,442,50.98,867,98.97,9,1.03,876
1,NSW,108,St Ives East,732,49.29,753,50.71,1485,98.61,21,1.39,1506
1,NSW,108,St Ives North,594,46.44,685,53.56,1279,98.08,25,1.92,1304
1,NSW,108,St Ives PPVC,1606,39.35,2475,60.65,4081,99.44,23,0.56,4104
1,NSW,108,St Ives South,738,51.11,706,48.89,1444,98.77,18,1.23,1462
1,NSW,119,St Johns Park,349,35.94,622,64.06,971,97.29,27,2.71,998
1,NSW,137,St Leonards,345,65.22,184,34.78,529,99.06,5,0.94,534
1,NSW,128,St Marys,432,39.42,664,60.58,1096,97.77,25,2.23,1121
1,NSW,111,St Marys CHIFLEY PPVC,275,32.24,578,67.76,853,98.5,13,1.5,866
1,NSW,128,St Marys LINDSAY PPVC,1658,27.71,4325,72.29,5983,98.96,63,1.04,6046
1,NSW,315,St Marys MCMAHON PPVC,724,23.02,2421,76.98,3145,99.31,22,0.69,3167
1,NSW,128,St Marys North,373,31.21,822,68.79,1195,97.63,29,2.37,1224
1,NSW,128,St Marys South,516,32.05,1094,67.95,1610,98.77,20,1.23,1630
1,NSW,121,St Peters,682,86.55,106,13.45,788,99.12,7,0.88,795
1,NSW,122,Stanhope Gardens,1377,54.23,1162,45.77,2539,98.56,37,1.44,2576
1,NSW,122,Stanhope Gardens North,193,55.46,155,44.54,348,99.15,3,0.85,351
1,NSW,121,Stanmore,1779,86.91,268,13.09,2047,99.27,15,0.73,2062
1,NSW,121,Stanmore North,607,73.13,223,26.87,830,98.34,14,1.66,844
1,NSW,114,Stanwell Park,534,68.11,250,31.89,784,99.37,5,0.63,789
1,NSW,250,Stockinbingal,30,20.69,115,79.31,145,100,0,0,145
1,NSW,136,Stockton,720,49.35,739,50.65,1459,98.65,20,1.35,1479
1,NSW,145,Stokers Siding,202,51.4,191,48.6,393,98.99,4,1.01,397
1,NSW,130,Stratford,35,17.95,160,82.05,195,100,0,0,195
1,NSW,144,Strathfield,523,47.37,581,52.63,1104,99.19,9,0.81,1113
1,NSW,144,Strathfield Central,790,38.97,1237,61.03,2027,99.07,19,0.93,2046
1,NSW,144,Strathfield North,812,46.94,918,53.06,1730,98.97,18,1.03,1748
1,NSW,144,Strathfield South (Reid),443,46.44,511,53.56,954,98.25,17,1.75,971
1,NSW,251,Strathfield South (Watson),367,45.31,443,54.69,810,98.06,16,1.94,826
1,NSW,144,Strathfield West,333,34.62,629,65.38,962,99.28,7,0.72,969
1,NSW,130,Stroud,150,27.12,403,72.88,553,98.4,9,1.6,562
1,NSW,130,Stroud Road,47,26.26,132,73.74,179,99.44,1,0.56,180
1,NSW,109,Stuart Town,20,9.35,194,90.65,214,99.53,1,0.47,215
1,NSW,113,Stuarts Point,175,28.32,443,71.68,618,97.32,17,2.68,635
1,NSW,145,Suffolk Park,680,74.56,232,25.44,912,98.49,14,1.51,926
1,NSW,121,Summer Hill,894,83.09,182,16.91,1076,97.91,23,2.09,1099
1,NSW,121,Summer Hill South,1205,82.37,258,17.63,1463,99.19,12,0.81,1475
1,NSW,148,Summerland Point,316,27.45,835,72.55,1151,98.97,12,1.03,1163
1,NSW,120,Sunshine Bay,293,36.86,502,63.14,795,98.27,14,1.73,809
1,NSW,149,Surry Hills,504,81.16,117,18.84,621,99.36,4,0.64,625
1,NSW,149,Surry Hills East (Sydney),341,81,80,19,421,99.29,3,0.71,424
1,NSW,152,Surry Hills East (Wentworth),147,82.58,31,17.42,178,98.34,3,1.66,181
1,NSW,149,Surry Hills North,1171,80.7,280,19.3,1451,99.25,11,0.75,1462
1,NSW,149,Surry Hills South,1499,80.2,370,19.8,1869,98.73,24,1.27,1893
1,NSW,149,Surry Hills West,465,73.11,171,26.89,636,98.76,8,1.24,644
1,NSW,120,Sussex Inlet,367,23.99,1163,76.01,1530,98.52,23,1.48,1553
1,NSW,124,Sutherland,1172,51.22,1116,48.78,2288,99.09,21,0.91,2309
1,NSW,124,Sutherland East,599,52.96,532,47.04,1131,98.52,17,1.48,1148
1,NSW,124,Sutherland North,909,46.95,1027,53.05,1936,99.28,14,0.72,1950
1,NSW,117,Sutton,378,45.71,449,54.29,827,99.28,6,0.72,833
1,NSW,150,Sutton Forest,57,32.57,118,67.43,175,98.87,2,1.13,177
1,NSW,148,Swansea,341,35.89,609,64.11,950,98.96,10,1.04,960
1,NSW,148,Swansea Central,867,40.19,1290,59.81,2157,98.85,25,1.15,2182
1,NSW,121,Sydenham,387,72.07,150,27.93,537,99.08,5,0.92,542
1,NSW,112,Sylvania,359,29.99,838,70.01,1197,99.25,9,0.75,1206
1,NSW,112,Sylvania Heights,617,31.5,1342,68.5,1959,98.94,21,1.06,1980
1,NSW,112,Sylvania Heights South,213,31.89,455,68.11,668,99.26,5,0.74,673
1,NSW,112,Sylvania South,297,33.87,580,66.13,877,99.32,6,0.68,883
1,NSW,118,Table Top,177,33.15,357,66.85,534,99.63,2,0.37,536
1,NSW,113,Tacking Point,656,47.16,735,52.84,1391,98.37,23,1.63,1414
1,NSW,125,Tahmoor,462,26.26,1297,73.74,1759,98.88,20,1.12,1779
1,NSW,125,Tahmoor PPVC,1425,19.38,5928,80.62,7353,99.28,53,0.72,7406
1,NSW,117,Talbingo,22,33.33,44,66.67,66,98.51,1,1.49,67
1,NSW,125,Tallong,82,25.23,243,74.77,325,99.39,2,0.61,327
1,NSW,139,Tambar Springs,17,21.52,62,78.48,79,96.34,3,3.66,82
1,NSW,135,Tamworth,944,68.41,436,31.59,1380,99.21,11,0.79,1391
1,NSW,135,Tamworth Central PPVC,777,17.52,3658,82.48,4435,99.42,26,0.58,4461
1,NSW,135,Tamworth East,653,40.43,962,59.57,1615,97.7,38,2.3,1653
1,NSW,135,Tamworth North,320,34.9,597,65.1,917,99.35,6,0.65,923
1,NSW,135,Tamworth PPVC,3213,20.67,12331,79.33,15544,99.23,120,0.77,15664
1,NSW,135,Tamworth South,496,28.09,1270,71.91,1766,98.11,34,1.89,1800
1,NSW,135,Tamworth West,186,28.4,469,71.6,655,98.2,12,1.8,667
1,NSW,249,Tanilba Bay,479,29.62,1138,70.38,1617,98.36,27,1.64,1644
1,NSW,117,Tanja,72,79.12,19,20.88,91,100,0,0,91
1,NSW,125,Tarago,112,30.77,252,69.23,364,99.73,1,0.27,365
1,NSW,125,Taralga,92,26.06,261,73.94,353,99.72,1,0.28,354
1,NSW,250,Tarcutta,33,12.55,230,87.45,263,99.62,1,0.38,264
1,NSW,130,Taree,482,24.74,1466,75.26,1948,98.48,30,1.52,1978
1,NSW,130,Taree North,120,25.26,355,74.74,475,97.94,10,2.06,485
1,NSW,130,Taree PPVC,2384,17.18,11495,82.82,13879,99.05,133,0.95,14012
1,NSW,130,Taree West,344,25.09,1027,74.91,1371,98.49,21,1.51,1392
1,NSW,112,Taren Point,292,26.57,807,73.43,1099,99.1,10,0.9,1109
1,NSW,114,Tarrawanna,545,51.37,516,48.63,1061,98.42,17,1.58,1078
1,NSW,249,Tarro,98,30.25,226,69.75,324,99.08,3,0.92,327
1,NSW,117,Tathra,458,56.2,357,43.8,815,98.67,11,1.33,826
1,NSW,250,Tatton,530,38.46,848,61.54,1378,98.85,16,1.15,1394
1,NSW,113,Taylors Arm,53,25.98,151,74.02,204,99.51,1,0.49,205
1,NSW,130,Tea Gardens,459,26.61,1266,73.39,1725,99.37,11,0.63,1736
1,NSW,249,Telarah,298,37.34,500,62.66,798,98.4,13,1.6,811
1,NSW,113,Telegraph Point,137,27.85,355,72.15,492,98.4,8,1.6,500
1,NSW,140,Telopea,724,44.97,886,55.03,1610,98.77,20,1.23,1630
1,NSW,250,Temora,196,20.99,738,79.01,934,99.05,9,0.95,943
1,NSW,250,Temora PPVC,394,16.13,2048,83.87,2442,99.47,13,0.53,2455
1,NSW,250,Temora West,53,14.64,309,85.36,362,98.64,5,1.36,367
1,NSW,104,Tempe,712,67.62,341,32.38,1053,98.32,18,1.68,1071
1,NSW,249,Tenambit,528,38.54,842,61.46,1370,98.77,17,1.23,1387
1,NSW,135,Tenterfield,130,23.77,417,76.23,547,99.09,5,0.91,552
1,NSW,135,Tenterfield PPVC,416,17.92,1905,82.08,2321,99.44,13,0.56,2334
1,NSW,126,Teralba,444,38.95,696,61.05,1140,98.62,16,1.38,1156
1,NSW,120,Terara,109,27.39,289,72.61,398,99,4,1,402
1,NSW,145,Terranora,421,38.38,676,61.62,1097,98.39,18,1.61,1115
1,NSW,132,Terrey Hills,558,48.1,602,51.9,1160,98.72,15,1.28,1175
1,NSW,146,Terrigal,668,57.09,502,42.91,1170,98.32,20,1.68,1190
1,NSW,146,Terrigal Lagoon,769,49.36,789,50.64,1558,98.61,22,1.39,1580
1,NSW,146,Terrigal South,281,50.27,278,49.73,559,99.29,4,0.71,563
1,NSW,146,Terrigal West,671,45.9,791,54.1,1462,99.05,14,0.95,1476
1,NSW,138,The Channon,225,80.07,56,19.93,281,97.91,6,2.09,287
1,NSW,115,The Entrance,550,41.32,781,58.68,1331,98.01,27,1.99,1358
1,NSW,115,The Entrance North,243,36.82,417,63.18,660,98.65,9,1.35,669
1,NSW,115,The Entrance PPVC,3710,33.27,7440,66.73,11150,98.99,114,1.01,11264
1,NSW,136,The Junction,1380,66.16,706,33.84,2086,98.35,35,1.65,2121
1,NSW,125,The Oaks,299,21.12,1117,78.88,1416,99.23,11,0.77,1427
1,NSW,122,The Ponds,1305,48.41,1391,51.59,2696,98.72,35,1.28,2731
1,NSW,111,The Ponds CHIFLEY PPVC,1042,41.48,1470,58.52,2512,98.98,26,1.02,2538
1,NSW,122,The Ponds GREENWAY PPVC,6429,41.63,9014,58.37,15443,99.09,142,0.91,15585
1,NSW,134,The Ponds MITCHELL PPVC,979,38.17,1586,61.83,2565,98.92,28,1.08,2593
1,NSW,122,The Ponds North,324,45.76,384,54.24,708,98.47,11,1.53,719
1,NSW,122,The Ponds West,862,48.4,919,51.6,1781,99.39,11,0.61,1792
1,NSW,250,The Rock,103,17.7,479,82.3,582,98.15,11,1.85,593
1,NSW,127,The Spot,582,70.55,243,29.45,825,98.57,12,1.43,837
1,NSW,125,Thirlmere,476,28.61,1188,71.39,1664,98.46,26,1.54,1690
1,NSW,114,Thirroul,1296,69.6,566,30.4,1862,98.41,30,1.59,1892
1,NSW,114,Thirroul East,337,69.92,145,30.08,482,98.77,6,1.23,488
1,NSW,113,Thora,179,61.3,113,38.7,292,97.99,6,2.01,298
1,NSW,106,Thornleigh,539,55.4,434,44.6,973,99.18,8,0.82,981
1,NSW,249,Thornton,717,35.18,1321,64.82,2038,98.41,33,1.59,2071
1,NSW,249,Thornton PPVC,796,29.89,1867,70.11,2663,98.96,28,1.04,2691
1,NSW,113,Thrumster,105,32.11,222,67.89,327,99.7,1,0.3,328
1,NSW,118,Thurgoona,571,35.55,1035,64.45,1606,99.07,15,0.93,1621
1,NSW,118,Thurgoona East,442,38.3,712,61.7,1154,98.97,12,1.03,1166
1,NSW,136,Tighes Hill,261,75.65,84,24.35,345,98.85,4,1.15,349
1,NSW,135,Timbumburi,76,26.67,209,73.33,285,98.62,4,1.38,289
1,NSW,135,Tingha,45,13.51,288,86.49,333,99.7,1,0.3,334
1,NSW,130,Tinonee,162,25.71,468,74.29,630,99.37,4,0.63,634
1,NSW,145,Tintenbar,219,49.32,225,50.68,444,99.33,3,0.67,447
1,NSW,118,Tocumwal,217,19.64,888,80.36,1105,98.75,14,1.25,1119
1,NSW,250,Tolland,223,35.28,409,64.72,632,98.6,9,1.4,641
1,NSW,120,Tomakin,268,48.73,282,51.27,550,98.74,7,1.26,557
1,NSW,120,Tomerong,235,37.84,386,62.16,621,98.57,9,1.43,630
1,NSW,139,Tomingley,17,11.64,129,88.36,146,100,0,0,146
1,NSW,118,Tooleybuc,27,16.56,136,83.44,163,100,0,0,163
1,NSW,122,Toongabbie,1201,46.41,1387,53.59,2588,98.89,29,1.11,2617
1,NSW,140,Toongabbie East,297,41.83,413,58.17,710,98.75,9,1.25,719
1,NSW,140,Toongabbie West,587,47.96,637,52.04,1224,99.03,12,0.97,1236
1,NSW,139,Tooraweenah,22,13.17,145,86.83,167,100,0,0,167
1,NSW,113,Toormina,674,37.4,1128,62.6,1802,97.67,43,2.33,1845
1,NSW,113,Toormina South,246,52.79,220,47.21,466,98.73,6,1.27,472
1,NSW,105,Top Ryde,968,52.9,862,47.1,1830,98.71,24,1.29,1854
1,NSW,126,Toronto,391,44.13,495,55.87,886,99.11,8,0.89,894
1,NSW,126,Toronto PPVC,2614,32.16,5514,67.84,8128,99.01,81,0.99,8209
1,NSW,139,Tottenham,26,8.41,283,91.59,309,99.04,3,0.96,312
1,NSW,115,Toukley,248,34.44,472,65.56,720,98.36,12,1.64,732
1,NSW,115,Toukley DOBELL PPVC,2918,27.85,7559,72.15,10477,98.93,113,1.07,10590
1,NSW,115,Toukley East,800,38.74,1265,61.26,2065,98.15,39,1.85,2104
1,NSW,148,Toukley SHORTLAND PPVC,197,28.89,485,71.11,682,99.13,6,0.87,688
1,NSW,117,Towamba,58,45.31,70,54.69,128,100,0,0,128
1,NSW,114,Towradgi,689,55.16,560,44.84,1249,98.81,15,1.19,1264
1,NSW,139,Trangie,101,17.24,485,82.76,586,98.82,7,1.18,593
1,NSW,111,Tregear,387,30.86,867,69.14,1254,98.2,23,1.8,1277
1,NSW,250,Trundle,46,20.44,179,79.56,225,98.68,3,1.32,228
1,NSW,109,Trunkey,14,13.46,90,86.54,104,100,0,0,104
1,NSW,138,Tucabia,73,24.83,221,75.17,294,99.66,1,0.34,295
1,NSW,115,Tuggerah,311,38.63,494,61.37,805,98.17,15,1.83,820
1,NSW,117,Tuggeranong EDEN-MONARO PPVC,128,38.1,208,61.9,336,99.12,3,0.88,339
1,NSW,115,Tuggerawong,356,31.73,766,68.27,1122,97.82,25,2.18,1147
1,NSW,250,Tullamore,36,24.32,112,75.68,148,98.67,2,1.33,150
1,NSW,139,Tullibigeal,15,9.32,146,90.68,161,98.17,3,1.83,164
1,NSW,150,Tullimbar,247,46.87,280,53.13,527,99.25,4,0.75,531
1,NSW,117,Tumbarumba,267,23.34,877,76.66,1144,97.86,25,2.14,1169
1,NSW,115,Tumbi Umbi,310,36.82,532,63.18,842,98.83,10,1.17,852
1,NSW,250,Tumblong,10,8.62,106,91.38,116,99.15,1,0.85,117
1,NSW,145,Tumbulgum,208,49.17,215,50.83,423,100,0,0,423
1,NSW,117,Tumut,196,30.82,440,69.18,636,97.4,17,2.6,653
1,NSW,117,Tumut East,110,33.43,219,66.57,329,97.05,10,2.95,339
1,NSW,117,Tumut PPVC,1069,22.35,3714,77.65,4783,98.9,53,1.1,4836
1,NSW,130,Tuncurry,321,27.27,856,72.73,1177,98.82,14,1.18,1191
1,NSW,117,Tura Beach,273,39.11,425,60.89,698,98.73,9,1.27,707
1,NSW,120,Tuross Head,427,39.61,651,60.39,1078,98.81,13,1.19,1091
1,NSW,108,Turramurra Central,335,53.95,286,46.05,621,99.36,4,0.64,625
1,NSW,108,Turramurra North,810,55.4,652,44.6,1462,99.19,12,0.81,1474
1,NSW,108,Turramurra PPVC,2677,44.81,3297,55.19,5974,99.3,42,0.7,6016
1,NSW,108,Turramurra Valley,83,60.14,55,39.86,138,99.28,1,0.72,139
1,NSW,104,Turrella,744,50.54,728,49.46,1472,97.68,35,2.32,1507
1,NSW,250,Turvey Park,581,44.25,732,55.75,1313,98.57,19,1.43,1332
1,NSW,145,Tweed Heads,400,45.35,482,54.65,882,98,18,2,900
1,NSW,145,Tweed Heads Central,347,42.63,467,57.37,814,99.03,8,0.97,822
1,NSW,145,Tweed Heads RICHMOND PPVC,2698,27.54,7099,72.46,9797,99.04,95,0.96,9892
1,NSW,145,Tweed Heads South,463,35.4,845,64.6,1308,98.12,25,1.88,1333
1,NSW,145,Tweed Heads South PPVC,2121,27.03,5725,72.97,7846,99.15,67,0.85,7913
1,NSW,145,Tweed Heads West,463,35.4,845,64.6,1308,98.35,22,1.65,1330
1,NSW,109,Tweed Mills,119,26.8,325,73.2,444,98.23,8,1.77,452
1,NSW,145,Tyalgum,190,41.39,269,58.61,459,98.92,5,1.08,464
1,NSW,145,Uki,380,50.94,366,49.06,746,97.01,23,2.99,769
1,NSW,120,Ulladulla,683,42.13,938,57.87,1621,98.24,29,1.76,1650
1,NSW,120,Ulladulla PPVC,3777,36.35,6615,63.65,10392,99.17,87,0.83,10479
1,NSW,138,Ulmarra,78,19.65,319,80.35,397,99.75,1,0.25,398
1,NSW,103,Ultimo (Banks),9,52.94,8,47.06,17,100,0,0,17
1,NSW,104,Ultimo (Barton),17,48.57,18,51.43,35,100,0,0,35
1,NSW,105,Ultimo (Bennelong),14,51.85,13,48.15,27,96.43,1,3.57,28
1,NSW,108,Ultimo (Bradfield),15,65.22,8,34.78,23,100,0,0,23
1,NSW,121,Ultimo (Grayndler),35,79.55,9,20.45,44,100,0,0,44
1,NSW,127,Ultimo (Kingsford Smith),16,66.67,8,33.33,24,96,1,4,25
1,NSW,137,Ultimo (North Sydney),21,61.76,13,38.24,34,100,0,0,34
1,NSW,140,Ultimo (Parramatta),5,45.45,6,54.55,11,100,0,0,11
1,NSW,144,Ultimo (Reid),12,63.16,7,36.84,19,100,0,0,19
1,NSW,149,Ultimo (Sydney),651,66.98,321,33.02,972,99.18,8,0.82,980
1,NSW,251,Ultimo (Watson),5,55.56,4,44.44,9,81.82,2,18.18,11
1,NSW,152,Ultimo (Wentworth),12,66.67,6,33.33,18,100,0,0,18
1,NSW,103,Ultimo BANKS PPVC,90,63.38,52,36.62,142,99.3,1,0.7,143
1,NSW,104,Ultimo BARTON PPVC,185,65.14,99,34.86,284,100,0,0,284
1,NSW,105,Ultimo BENNELONG PPVC,55,33.13,111,66.87,166,98.81,2,1.19,168
1,NSW,106,Ultimo BEROWRA PPVC,67,59.82,45,40.18,112,99.12,1,0.88,113
1,NSW,107,Ultimo BLAXLAND PPVC,57,52.29,52,47.71,109,98.2,2,1.8,111
1,NSW,108,Ultimo BRADFIELD PPVC,100,69.93,43,30.07,143,100,0,0,143
1,NSW,112,Ultimo COOK PPVC,55,46.61,63,53.39,118,97.52,3,2.48,121
1,NSW,149,Ultimo East,411,76.11,129,23.89,540,98.9,6,1.1,546
1,NSW,119,Ultimo FOWLER PPVC,59,57.28,44,42.72,103,99.04,1,0.96,104
1,NSW,121,Ultimo GRAYNDLER PPVC,501,85.2,87,14.8,588,99.32,4,0.68,592
1,NSW,122,Ultimo GREENWAY PPVC,50,58.82,35,41.18,85,100,0,0,85
1,NSW,124,Ultimo HUGHES PPVC,53,50.48,52,49.52,105,99.06,1,0.94,106
1,NSW,127,Ultimo KINGSFORD SMITH PPVC,215,70.03,92,29.97,307,99.03,3,0.97,310
1,NSW,132,Ultimo MACKELLAR PPVC,84,69.42,37,30.58,121,98.37,2,1.63,123
1,NSW,134,Ultimo MITCHELL PPVC,74,67.89,35,32.11,109,98.2,2,1.8,111
1,NSW,137,Ultimo NORTH SYDNEY PPVC,179,74.9,60,25.1,239,98.35,4,1.65,243
1,NSW,140,Ultimo PARRAMATTA PPVC,93,57.76,68,42.24,161,100,0,0,161
1,NSW,144,Ultimo REID PPVC,192,65.98,99,34.02,291,99.32,2,0.68,293
1,NSW,149,Ultimo SYDNEY PPVC,3244,69.99,1391,30.01,4635,98.79,57,1.21,4692
1,NSW,151,Ultimo WARRINGAH PPVC,110,71.43,44,28.57,154,99.35,1,0.65,155
1,NSW,251,Ultimo WATSON PPVC,121,65.41,64,34.59,185,99.46,1,0.54,186
1,NSW,152,Ultimo WENTWORTH PPVC,165,73.99,58,26.01,223,98.24,4,1.76,227
1,NSW,153,Ultimo WERRIWA PPVC,60,63.83,34,36.17,94,100,0,0,94
1,NSW,146,Umina,523,45.56,625,54.44,1148,97.87,25,2.13,1173
1,NSW,146,Umina Beach,596,50.47,585,49.53,1181,98.5,18,1.5,1199
1,NSW,146,Umina Central,507,43.56,657,56.44,1164,98.81,14,1.19,1178
1,NSW,146,Umina PPVC,885,41.05,1271,58.95,2156,98.94,23,1.06,2179
1,NSW,146,Umina West,571,46.69,652,53.31,1223,98.55,18,1.45,1241
1,NSW,114,Unanderra,731,46.09,855,53.91,1586,99,16,1,1602
1,NSW,114,Unanderra South,668,47.71,732,52.29,1400,97.97,29,2.03,1429
1,NSW,114,Unanderra West,259,47.26,289,52.74,548,99.28,4,0.72,552
1,NSW,104,Undercliffe,817,54.61,679,45.39,1496,98.42,24,1.58,1520
1,NSW,250,Ungarie,29,14.29,174,85.71,203,97.6,5,2.4,208
1,NSW,130,Upper Lansdowne,48,35.56,87,64.44,135,98.54,2,1.46,137
1,NSW,113,Upper Orara,121,38.29,195,61.71,316,98.75,4,1.25,320
1,NSW,135,Uralla,298,32.15,629,67.85,927,98.72,12,1.28,939
1,NSW,118,Urana,38,19.1,161,80.9,199,100,0,0,199
1,NSW,250,Uranquinty,96,22.48,331,77.52,427,98.84,5,1.16,432
1,NSW,135,Urbenville,27,18.12,122,81.88,149,100,0,0,149
1,NSW,113,Urunga,662,41.22,944,58.78,1606,97.99,33,2.01,1639
1,NSW,113,Utungun,56,26.92,152,73.08,208,98.58,3,1.42,211
1,NSW,130,Vacy,162,26.21,456,73.79,618,98.88,7,1.12,625
1,NSW,148,Valentine,742,42.82,991,57.18,1733,98.35,29,1.65,1762
1,NSW,148,Valentine West,274,43.42,357,56.58,631,98.75,8,1.25,639
1,NSW,113,Valla Beach,388,47.32,432,52.68,820,98.2,15,1.8,835
1,NSW,133,Valley Heights,230,49.78,232,50.22,462,99.35,3,0.65,465
1,NSW,131,Varroville,60,36.36,105,63.64,165,97.63,4,2.37,169
1,NSW,152,Vaucluse,553,48.05,598,51.95,1151,97.13,34,2.87,1185
1,NSW,152,Vaucluse East,141,59.24,97,40.76,238,98.35,4,1.65,242
1,NSW,119,Villawood,494,43.87,632,56.13,1126,97.49,29,2.51,1155
1,NSW,107,Villawood East,389,36.25,684,63.75,1073,94.87,58,5.13,1131
1,NSW,119,Villawood North,370,41.76,516,58.24,886,98.01,18,1.99,904
1,NSW,120,Vincentia,611,48.57,647,51.43,1258,98.59,18,1.41,1276
1,NSW,122,Vineyard East (Greenway),116,35.37,212,64.63,328,99.39,2,0.61,330
1,NSW,133,Vineyard East (Macquarie),52,21.76,187,78.24,239,96.76,8,3.24,247
1,NSW,115,Wadalba,598,36.96,1020,63.04,1618,98.6,23,1.4,1641
1,NSW,250,Wagga Wagga,704,46.04,825,53.96,1529,98.9,17,1.1,1546
1,NSW,250,Wagga Wagga North,338,32.41,705,67.59,1043,98.86,12,1.14,1055
1,NSW,250,Wagga Wagga PPVC,4277,26.83,11662,73.17,15939,99.12,141,0.88,16080
1,NSW,250,Wagga Wagga South,388,46.03,455,53.97,843,98.37,14,1.63,857
1,NSW,250,Wagga Wagga South PPVC,1276,25.91,3648,74.09,4924,99.33,33,0.67,4957
1,NSW,108,Wahroonga,641,52.54,579,47.46,1220,98.95,13,1.05,1233
1,NSW,108,Wahroonga East,984,55.62,785,44.38,1769,99.1,16,0.9,1785
1,NSW,108,Wahroonga South,329,51.09,315,48.91,644,99.23,5,0.77,649
1,NSW,108,Waitara,433,56.68,331,43.32,764,99.35,5,0.65,769
1,NSW,108,Waitara North,807,54.05,686,45.95,1493,99.2,12,0.8,1505
1,NSW,119,Wakeley,397,34.67,748,65.33,1145,98.2,21,1.8,1166
1,NSW,118,Wakool,19,10,171,90,190,100,0,0,190
1,NSW,118,Walbundrie,22,13.5,141,86.5,163,99.39,1,0.61,164
1,NSW,135,Walcha,214,19.09,907,80.91,1121,99.29,8,0.71,1129
1,NSW,139,Walgett,242,34.47,460,65.53,702,99.01,7,0.99,709
1,NSW,118,Walla Walla,67,18.01,305,81.99,372,99.2,3,0.8,375
1,NSW,135,Wallabadah,41,16.47,208,83.53,249,99.2,2,0.8,251
1,NSW,125,Wallacia,128,19.02,545,80.98,673,99.12,6,0.88,679
1,NSW,130,Wallarobba,29,26.13,82,73.87,111,100,0,0,111
1,NSW,250,Wallendbeen,16,17.02,78,82.98,94,98.95,1,1.05,95
1,NSW,109,Wallerawang,194,21.8,696,78.2,890,99.22,7,0.78,897
1,NSW,136,Wallsend,733,52.47,664,47.53,1397,98.87,16,1.13,1413
1,NSW,136,Wallsend East,316,49.84,318,50.16,634,98.75,8,1.25,642
1,NSW,126,Wallsend HUNTER PPVC,353,31.43,770,68.57,1123,99.29,8,0.71,1131
1,NSW,136,Wallsend NEWCASTLE PPVC,4957,39.02,7747,60.98,12704,98.96,133,1.04,12837
1,NSW,249,Wallsend PATERSON PPVC,88,25.81,253,74.19,341,99.42,2,0.58,343
1,NSW,148,Wallsend SHORTLAND PPVC,333,31.93,710,68.07,1043,99.05,10,0.95,1053
1,NSW,136,Wallsend South,1073,56.15,838,43.85,1911,98.91,21,1.09,1932
1,NSW,115,Wamberal (Dobell),317,47.81,346,52.19,663,98.66,9,1.34,672
1,NSW,146,Wamberal (Robertson),409,49.82,412,50.18,821,98.8,10,1.2,831
1,NSW,115,Wamberal North,440,50.63,429,49.37,869,98.75,11,1.25,880
1,NSW,117,Wamboin,303,58.95,211,41.05,514,98.85,6,1.15,520
1,NSW,118,Wamoon,27,15.52,147,84.48,174,98.31,3,1.69,177
1,NSW,126,Wangi Wangi,456,40.43,672,59.57,1128,98.77,14,1.23,1142
1,NSW,136,Warabrook,370,47.07,416,52.93,786,98.99,8,1.01,794
1,NSW,136,Waratah,1048,59.44,715,40.56,1763,99.16,15,0.84,1778
1,NSW,109,Waratah North Orange,139,41.87,193,58.13,332,100,0,0,332
1,NSW,136,Waratah West,425,50.78,412,49.22,837,98.47,13,1.53,850
1,NSW,138,Wardell,167,31.81,358,68.19,525,98.68,7,1.32,532
1,NSW,139,Warialda,120,12.62,831,87.38,951,99.69,3,0.31,954
1,NSW,150,Warilla East,549,40.79,797,59.21,1346,98.1,26,1.9,1372
1,NSW,150,Warilla North,249,39.4,383,60.6,632,98.44,10,1.56,642
1,NSW,150,Warilla PPVC,4328,30.8,9722,69.2,14050,98.74,180,1.26,14230
1,NSW,150,Warilla South,454,36.91,776,63.09,1230,98.64,17,1.36,1247
1,NSW,148,Warners Bay,712,39.23,1103,60.77,1815,98.59,26,1.41,1841
1,NSW,148,Warners Bay Central,439,48.78,461,51.22,900,98.15,17,1.85,917
1,NSW,148,Warners Bay North,596,42.88,794,57.12,1390,98.44,22,1.56,1412
1,NSW,115,Warnervale,34,41.98,47,58.02,81,98.78,1,1.22,82
1,NSW,115,Warnervale East,197,36.48,343,63.52,540,98.54,8,1.46,548
1,NSW,125,Warragamba,446,20.37,1744,79.63,2190,99.1,20,0.9,2210
1,NSW,108,Warrawee,1282,59.54,871,40.46,2153,99.13,19,0.87,2172
1,NSW,114,Warrawong,281,38.08,457,61.92,738,98.14,14,1.86,752
1,NSW,114,Warrawong Central,288,40.85,417,59.15,705,97.24,20,2.76,725
1,NSW,114,Warrawong CUNNINGHAM PPVC,1419,39.78,2148,60.22,3567,98.84,42,1.16,3609
1,NSW,150,Warrawong WHITLAM PPVC,896,37.22,1511,62.78,2407,98.61,34,1.39,2441
1,NSW,113,Warrell Creek,73,18.2,328,81.8,401,99.26,3,0.74,404
1,NSW,139,Warren,202,19.54,832,80.46,1034,99.14,9,0.86,1043
1,NSW,132,Warriewood,1427,51.26,1357,48.74,2784,98.34,47,1.66,2831
1,NSW,133,Warrimoo,435,60.75,281,39.25,716,99.44,4,0.56,720
1,NSW,119,Warwick Farm,425,46.15,496,53.85,921,98.29,16,1.71,937
1,NSW,115,Watanobbi,557,33.66,1098,66.34,1655,98.51,25,1.49,1680
1,NSW,149,Waterloo,498,61.18,316,38.82,814,98.55,12,1.45,826
1,NSW,152,Watsons Bay,735,60.74,475,39.26,1210,98.86,14,1.14,1224
1,NSW,109,Wattle Flat,54,24.88,163,75.12,217,99.09,2,0.91,219
1,NSW,124,Wattle Grove,806,39.63,1228,60.37,2034,98.5,31,1.5,2065
1,NSW,119,Wattle Grove FOWLER PPVC,277,26.87,754,73.13,1031,99.42,6,0.58,1037
1,NSW,124,Wattle Grove HUGHES PPVC,2807,34.48,5335,65.52,8142,99,82,1,8224
1,NSW,124,Wattle Grove South,231,42.39,314,57.61,545,99.45,3,0.55,548
1,NSW,153,Wattle Grove WERRIWA PPVC,223,33.84,436,66.16,659,98.65,9,1.35,668
1,NSW,130,Wauchope,272,28.01,699,71.99,971,98.48,15,1.52,986
1,NSW,130,Wauchope PPVC,1116,20.59,4303,79.41,5419,99.34,36,0.66,5455
1,NSW,130,Wauchope South,226,26.43,629,73.57,855,97.94,18,2.06,873
1,NSW,152,Waverley,867,74.81,292,25.19,1159,98.72,15,1.28,1174
1,NSW,127,Waverley KINGSFORD SMITH PPVC,140,64.22,78,35.78,218,100,0,0,218
1,NSW,152,Waverley North,352,70.54,147,29.46,499,98.62,7,1.38,506
1,NSW,152,Waverley WENTWORTH PPVC,4550,57.83,3318,42.17,7868,99.19,64,0.81,7932
1,NSW,137,Waverton,917,67.48,442,32.52,1359,99.27,10,0.73,1369
1,NSW,131,Wedderburn,85,25.84,244,74.16,329,98.8,4,1.2,333
1,NSW,139,Wee Waa,140,15.5,763,84.5,903,99.34,6,0.66,909
1,NSW,250,Weethalle,10,8.13,113,91.87,123,99.19,1,0.81,124
1,NSW,150,Welby,182,32.38,380,67.62,562,98.42,9,1.58,571
1,NSW,109,Wellington,424,26.06,1203,73.94,1627,98.49,25,1.51,1652
1,NSW,109,Wellington East,198,23.63,640,76.37,838,98.47,13,1.53,851
1,NSW,118,Wentworth,149,18.35,663,81.65,812,99.15,7,0.85,819
1,NSW,133,Wentworth Falls,1161,67.54,558,32.46,1719,99.08,16,0.92,1735
1,NSW,144,Wentworth Point,939,51.79,874,48.21,1813,98.75,23,1.25,1836
1,NSW,144,Wentworth Point North,837,48.05,905,51.95,1742,98.25,31,1.75,1773
1,NSW,140,Wentworthville,1121,59.12,775,40.88,1896,99.32,13,0.68,1909
1,NSW,140,Wentworthville Central,730,60.43,478,39.57,1208,99.34,8,0.66,1216
1,NSW,140,Wentworthville North,427,45.57,510,54.43,937,98.01,19,1.99,956
1,NSW,128,Werrington,625,38.65,992,61.35,1617,97.64,39,2.36,1656
1,NSW,128,Werrington County,371,26.18,1046,73.82,1417,98.81,17,1.19,1434
1,NSW,135,Werris Creek,176,24.28,549,75.72,725,99.04,7,0.96,732
1,NSW,130,West Haven,221,32.03,469,67.97,690,98.57,10,1.43,700
1,NSW,153,West Hoxton,311,31.07,690,68.93,1001,98.72,13,1.28,1014
1,NSW,153,West Hoxton Central,39,32.77,80,67.23,119,99.17,1,0.83,120
1,NSW,153,West Hoxton South,360,33.18,725,66.82,1085,97.57,27,2.43,1112
1,NSW,106,West Pennant Hills,698,49.93,700,50.07,1398,99.29,10,0.71,1408
1,NSW,106,West Pennant Hills Central,661,50.04,660,49.96,1321,98.8,16,1.2,1337
1,NSW,106,West Pennant Hills North (Berowra),765,49.74,773,50.26,1538,92.82,119,7.18,1657
1,NSW,134,West Pennant Hills North (Mitchell),304,41.36,431,58.64,735,98.66,10,1.34,745
1,NSW,105,West Ryde,1139,57.76,833,42.24,1972,98.6,28,1.4,2000
1,NSW,105,West Ryde BENNELONG PPVC,4644,41.78,6471,58.22,11115,98.94,119,1.06,11234
1,NSW,105,West Ryde Central,387,45.64,461,54.36,848,98.6,12,1.4,860
1,NSW,137,West Ryde NORTH SYDNEY PPVC,684,44.62,849,55.38,1533,99.48,8,0.52,1541
1,NSW,140,West Ryde PARRAMATTA PPVC,202,40.73,294,59.27,496,98.8,6,1.2,502
1,NSW,144,West Ryde REID PPVC,507,44.63,629,55.37,1136,98.95,12,1.05,1148
1,NSW,126,West Wallsend,481,32.09,1018,67.91,1499,98.42,24,1.58,1523
1,NSW,250,West Wyalong,125,21.26,463,78.74,588,98.49,9,1.51,597
1,NSW,135,Westdale,163,20.3,640,79.7,803,99.14,7,0.86,810
1,NSW,106,Westleigh,1598,58.24,1146,41.76,2744,99.17,23,0.83,2767
1,NSW,140,Westmead,1251,58.54,886,41.46,2137,98.57,31,1.43,2168
1,NSW,140,Westmead Central,489,58.01,354,41.99,843,98.94,9,1.06,852
1,NSW,140,Westmead South,355,53.14,313,46.86,668,99.26,5,0.74,673
1,NSW,249,Weston,223,26.58,616,73.42,839,98.59,12,1.41,851
1,NSW,119,Wetherill Park (Fowler),113,28.75,280,71.25,393,98.25,7,1.75,400
1,NSW,315,Wetherill Park (McMahon),257,22.72,874,77.28,1131,98.26,20,1.74,1151
1,NSW,119,Wetherill Park FOWLER PPVC,1553,29.1,3783,70.9,5336,98.6,76,1.4,5412
1,NSW,315,Wetherill Park MCMAHON PPVC,2326,27.07,6265,72.93,8591,98.53,128,1.47,8719
1,NSW,153,Wetherill Park WERRIWA PPVC,313,22.36,1087,77.64,1400,98.04,28,1.96,1428
1,NSW,111,Whalan,470,38.34,756,61.66,1226,97.53,31,2.47,1257
1,NSW,132,Wheeler Heights,941,56.35,729,43.65,1670,98.64,23,1.36,1693
1,NSW,130,Wherrol Flat,66,37.29,111,62.71,177,97.25,5,2.75,182
1,NSW,148,Whitebridge,496,51.56,466,48.44,962,99.07,9,0.93,971
1,NSW,118,Whitton,64,21.92,228,78.08,292,98.65,4,1.35,296
1,NSW,138,Wiangaree,96,23.19,318,76.81,414,98.1,8,1.9,422
1,NSW,136,Wickham,574,71.48,229,28.52,803,99.26,6,0.74,809
1,NSW,133,Wilberforce,279,22.43,965,77.57,1244,98.97,13,1.03,1257
1,NSW,139,Wilcannia,62,39.24,96,60.76,158,96.93,5,3.07,163
1,NSW,251,Wiley Park East,521,54.67,432,45.33,953,96.65,33,3.35,986
1,NSW,251,Wiley Park West,807,51.04,774,48.96,1581,97.17,46,2.83,1627
1,NSW,113,Willawarrin,66,24.26,206,75.74,272,100,0,0,272
1,NSW,249,Williamtown,118,30.81,265,69.19,383,99.48,2,0.52,385
1,NSW,111,Willmot,279,35.27,512,64.73,791,98.75,10,1.25,801
1,NSW,137,Willoughby,1014,60.32,667,39.68,1681,99.06,16,0.94,1697
1,NSW,108,Willoughby BRADFIELD PPVC,864,45.67,1028,54.33,1892,98.9,21,1.1,1913
1,NSW,137,Willoughby North,1074,64.89,581,35.11,1655,99.22,13,0.78,1668
1,NSW,137,Willoughby NORTH SYDNEY PPVC,4017,51.61,3766,48.39,7783,99.13,68,0.87,7851
1,NSW,137,Willoughby South,596,56.98,450,43.02,1046,98.68,14,1.32,1060
1,NSW,135,Willow Tree,50,12.92,337,87.08,387,98.98,4,1.02,391
1,NSW,145,Wilsons Creek,145,71.78,57,28.22,202,97.12,6,2.88,208
1,NSW,125,Wilton,468,28.94,1149,71.06,1617,98.66,22,1.34,1639
1,NSW,148,Windale,433,31.4,946,68.6,1379,98.01,28,1.99,1407
1,NSW,150,Windang,322,37.35,540,62.65,862,98.85,10,1.15,872
1,NSW,109,Windradyne PPVC,1130,28.69,2809,71.31,3939,99.14,34,0.86,3973
1,NSW,133,Windsor,311,32.23,654,67.77,965,98.57,14,1.43,979
1,NSW,133,Windsor PPVC,1506,23.89,4798,76.11,6304,99.35,41,0.65,6345
1,NSW,133,Windsor South,421,30.35,966,69.65,1387,98.02,28,1.98,1415
1,NSW,125,Wingello,144,39.02,225,60.98,369,98.66,5,1.34,374
1,NSW,135,Wingen,36,20.69,138,79.31,174,100,0,0,174
1,NSW,130,Wingham,206,22.03,729,77.97,935,99.05,9,0.95,944
1,NSW,130,Wingham West,353,24.58,1083,75.42,1436,96.9,46,3.1,1482
1,NSW,133,Winmalee,593,48.41,632,51.59,1225,98.47,19,1.53,1244
1,NSW,134,Winston Hills,1135,39.98,1704,60.02,2839,98.95,30,1.05,2869
1,NSW,134,Winston Hills North,670,38.11,1088,61.89,1758,98.93,19,1.07,1777
1,NSW,249,Wirreanda Medowie,649,32.4,1354,67.6,2003,98.91,22,1.09,2025
1,NSW,106,Wisemans Ferry,27,22.5,93,77.5,120,99.17,1,0.83,121
1,NSW,117,Woden EDEN-MONARO PPVC,178,58.55,126,41.45,304,99.67,1,0.33,305
1,NSW,126,Wollombi,193,57.44,143,42.56,336,99.41,2,0.59,338
1,NSW,138,Wollongbar,434,37.97,709,62.03,1143,98.2,21,1.8,1164
1,NSW,114,Wollongong,741,62.69,441,37.31,1182,97.69,28,2.31,1210
1,NSW,114,Wollongong CUNNINGHAM PPVC,7002,52.94,6224,47.06,13226,98.89,149,1.11,13375
1,NSW,114,Wollongong East,603,59.41,412,40.59,1015,98.35,17,1.65,1032
1,NSW,114,Wollongong North,825,64.25,459,35.75,1284,98.39,21,1.61,1305
1,NSW,114,Wollongong South,476,55.74,378,44.26,854,98.5,13,1.5,867
1,NSW,114,Wollongong West,806,55.4,649,44.6,1455,99.05,14,0.95,1469
1,NSW,150,Wollongong WHITLAM PPVC,518,43.09,684,56.91,1202,98.52,18,1.48,1220
1,NSW,137,Wollstonecraft,1016,63.18,592,36.82,1608,99.01,16,0.99,1624
1,NSW,117,Wolumla,123,38.68,195,61.32,318,98.76,4,1.24,322
1,NSW,114,Wombarra,204,72.34,78,27.66,282,99.3,2,0.7,284
1,NSW,250,Wombat,30,20.55,116,79.45,146,98.65,2,1.35,148
1,NSW,139,Wongarbon,84,24.78,255,75.22,339,99.71,1,0.29,340
1,NSW,249,Woodberry,307,26.79,839,73.21,1146,98.45,18,1.55,1164
1,NSW,131,Woodbine,579,37.12,981,62.88,1560,98.05,31,1.95,1591
1,NSW,138,Woodburn,190,31.1,421,68.9,611,98.71,8,1.29,619
1,NSW,111,Woodcroft,526,43.47,684,56.53,1210,99.02,12,0.98,1222
1,NSW,138,Woodenbong,22,8.84,227,91.16,249,99.2,2,0.8,251
1,NSW,133,Woodford,611,60.5,399,39.5,1010,98.54,15,1.46,1025
1,NSW,126,Woodrising,332,37.35,557,62.65,889,98.89,10,1.11,899
1,NSW,250,Woodstock,55,19.16,232,80.84,287,99.65,1,0.35,288
1,NSW,130,Woodville,194,37.31,326,62.69,520,99.62,2,0.38,522
1,NSW,135,Woolbrook,18,16.07,94,83.93,112,100,0,0,112
1,NSW,138,Woolgoolga,774,37.18,1308,62.82,2082,98.49,32,1.51,2114
1,NSW,138,Woolgoolga Central,264,44.75,326,55.25,590,98.33,10,1.67,600
1,NSW,138,Wooli,115,28.54,288,71.46,403,98.77,5,1.23,408
1,NSW,152,Woollahra,723,66.51,364,33.49,1087,99.54,5,0.46,1092
1,NSW,152,Woollahra South,450,67.16,220,32.84,670,98.82,8,1.18,678
1,NSW,149,Woolloomooloo,569,66.24,290,33.76,859,99.19,7,0.81,866
1,NSW,135,Woolomin,37,21.02,139,78.98,176,100,0,0,176
1,NSW,112,Woolooware,850,45.36,1024,54.64,1874,98.63,26,1.37,1900
1,NSW,112,Woolooware North,155,41.01,223,58.99,378,98.95,4,1.05,382
1,NSW,138,Woombah,152,32.62,314,67.38,466,98.11,9,1.89,475
1,NSW,115,Woongarrah,499,28.98,1223,71.02,1722,98.85,20,1.15,1742
1,NSW,114,Woonona,638,64.77,347,35.23,985,98.6,14,1.4,999
1,NSW,114,Woonona Central,470,64.12,263,35.88,733,99.46,4,0.54,737
1,NSW,114,Woonona East,725,57.49,536,42.51,1261,99.06,12,0.94,1273
1,NSW,124,Woronora Heights,318,41.46,449,58.54,767,97.58,19,2.42,786
1,NSW,124,Woronora River,391,45.62,466,54.38,857,98.51,13,1.49,870
1,NSW,146,Woy Woy,380,48.59,402,51.41,782,97.99,16,2.01,798
1,NSW,146,Woy Woy PPVC,5270,36.58,9136,63.42,14406,99.04,140,0.96,14546
1,NSW,146,Woy Woy South,662,44.52,825,55.48,1487,98.28,26,1.72,1513
1,NSW,146,Woy Woy West,342,45.36,412,54.64,754,98.05,15,1.95,769
1,NSW,250,Wyalong,88,16.99,430,83.01,518,99.23,4,0.77,522
1,NSW,250,Wyalong PPVC,190,11.99,1395,88.01,1585,99.62,6,0.38,1591
1,NSW,126,Wyee,327,25.91,935,74.09,1262,99.45,7,0.55,1269
1,NSW,126,Wyee Point,118,26.52,327,73.48,445,99.11,4,0.89,449
1,NSW,117,Wyndham,150,58.14,108,41.86,258,98.85,3,1.15,261
1,NSW,103,Wynyard (Banks),21,53.85,18,46.15,39,97.5,1,2.5,40
1,NSW,104,Wynyard (Barton),38,53.52,33,46.48,71,94.67,4,5.33,75
1,NSW,105,Wynyard (Bennelong),42,62.69,25,37.31,67,100,0,0,67
1,NSW,108,Wynyard (Bradfield),44,68.75,20,31.25,64,100,0,0,64
1,NSW,121,Wynyard (Grayndler),78,72.9,29,27.1,107,99.07,1,0.93,108
1,NSW,127,Wynyard (Kingsford Smith),45,67.16,22,32.84,67,98.53,1,1.47,68
1,NSW,137,Wynyard (North Sydney),63,58.88,44,41.12,107,98.17,2,1.83,109
1,NSW,140,Wynyard (Parramatta),30,58.82,21,41.18,51,98.08,1,1.92,52
1,NSW,144,Wynyard (Reid),63,70,27,30,90,95.74,4,4.26,94
1,NSW,149,Wynyard (Sydney),504,65.2,269,34.8,773,98.47,12,1.53,785
1,NSW,251,Wynyard (Watson),27,56.25,21,43.75,48,97.96,1,2.04,49
1,NSW,152,Wynyard (Wentworth),42,66.67,21,33.33,63,100,0,0,63
1,NSW,103,Wynyard BANKS PPVC,256,52.78,229,47.22,485,98.78,6,1.22,491
1,NSW,104,Wynyard BARTON PPVC,483,57.84,352,42.16,835,99.4,5,0.6,840
1,NSW,105,Wynyard BENNELONG PPVC,405,53.22,356,46.78,761,99.48,4,0.52,765
1,NSW,106,Wynyard BEROWRA PPVC,247,57.44,183,42.56,430,99.54,2,0.46,432
1,NSW,107,Wynyard BLAXLAND PPVC,142,52.79,127,47.21,269,98.9,3,1.1,272
1,NSW,108,Wynyard BRADFIELD PPVC,451,56.09,353,43.91,804,99.5,4,0.5,808
1,NSW,112,Wynyard COOK PPVC,182,43.75,234,56.25,416,99.05,4,0.95,420
1,NSW,119,Wynyard FOWLER PPVC,126,59.72,85,40.28,211,97.69,5,2.31,216
1,NSW,121,Wynyard GRAYNDLER PPVC,1187,74.33,410,25.67,1597,99.19,13,0.81,1610
1,NSW,122,Wynyard GREENWAY PPVC,184,55.76,146,44.24,330,99.1,3,0.9,333
1,NSW,124,Wynyard HUGHES PPVC,186,51.67,174,48.33,360,98.09,7,1.91,367
1,NSW,127,Wynyard KINGSFORD SMITH PPVC,686,67.59,329,32.41,1015,98.93,11,1.07,1026
1,NSW,132,Wynyard MACKELLAR PPVC,282,60,188,40,470,99.37,3,0.63,473
1,NSW,134,Wynyard MITCHELL PPVC,345,53.08,305,46.92,650,99.39,4,0.61,654
1,NSW,137,Wynyard NORTH SYDNEY PPVC,1247,58.74,876,41.26,2123,99.02,21,0.98,2144
1,NSW,140,Wynyard PARRAMATTA PPVC,264,57.89,192,42.11,456,98.49,7,1.51,463
1,NSW,144,Wynyard REID PPVC,693,54.27,584,45.73,1277,99.07,12,0.93,1289
1,NSW,149,Wynyard SYDNEY PPVC,3414,64.02,1919,35.98,5333,99.09,49,0.91,5382
1,NSW,151,Wynyard WARRINGAH PPVC,727,64.85,394,35.15,1121,99.03,11,0.97,1132
1,NSW,251,Wynyard WATSON PPVC,227,52.3,207,47.7,434,98.41,7,1.59,441
1,NSW,152,Wynyard WENTWORTH PPVC,1003,65.13,537,34.87,1540,99.16,13,0.84,1553
1,NSW,153,Wynyard WERRIWA PPVC,114,45.6,136,54.4,250,98.81,3,1.19,253
1,NSW,115,Wyoming (Dobell),564,44.83,694,55.17,1258,98.67,17,1.33,1275
1,NSW,146,Wyoming (Robertson),342,46.15,399,53.85,741,98.93,8,1.07,749
1,NSW,115,Wyoming East,283,42.75,379,57.25,662,99.4,4,0.6,666
1,NSW,115,Wyoming North,389,48.87,407,51.13,796,98.76,10,1.24,806
1,NSW,115,Wyong,284,32.31,595,67.69,879,98.76,11,1.24,890
1,NSW,115,Wyong Creek,108,43.03,143,56.97,251,99.6,1,0.4,252
1,NSW,115,Wyong DOBELL PPVC,2427,32.03,5150,67.97,7577,99.12,67,0.88,7644
1,NSW,115,Wyong East,285,35.1,527,64.9,812,98.78,10,1.22,822
1,NSW,146,Wyong ROBERTSON PPVC,220,41.28,313,58.72,533,99.26,4,0.74,537
1,NSW,148,Wyong SHORTLAND PPVC,75,37.5,125,62.5,200,98.52,3,1.48,203
1,NSW,138,Wyrallah,118,30.41,270,69.59,388,99.74,1,0.26,389
1,NSW,107,Yagoona,371,40.46,546,59.54,917,96.73,31,3.27,948
1,NSW,107,Yagoona West,390,35.23,717,64.77,1107,97.02,34,2.98,1141
1,NSW,138,Yamba,681,47.06,766,52.94,1447,98.7,19,1.3,1466
1,NSW,138,Yamba West,263,24.6,806,75.4,1069,98.07,21,1.93,1090
1,NSW,118,Yanco,46,19.33,192,80.67,238,98.35,4,1.65,242
1,NSW,125,Yanderra,74,22.7,252,77.3,326,99.39,2,0.61,328
1,NSW,115,Yarramalong,106,44.17,134,55.83,240,100,0,0,240
1,NSW,133,Yarramundi,62,24.22,194,75.78,256,99.61,1,0.39,257
1,NSW,124,Yarrawarrah,454,47.64,499,52.36,953,99.06,9,0.94,962
1,NSW,135,Yarrowitch,8,11.59,61,88.41,69,100,0,0,69
1,NSW,117,Yass,177,48.63,187,51.37,364,99.45,2,0.55,366
1,NSW,117,Yass Central,418,42.48,566,57.52,984,98.99,10,1.01,994
1,NSW,117,Yass North,184,44.12,233,55.88,417,99.52,2,0.48,419
1,NSW,117,Yass PPVC,1419,33.19,2856,66.81,4275,98.96,45,1.04,4320
1,NSW,118,Yenda,116,15.59,628,84.41,744,99.73,2,0.27,746
1,NSW,119,Yennora (Fowler),66,46.15,77,53.85,143,99.31,1,0.69,144
1,NSW,315,Yennora (McMahon),236,31.98,502,68.02,738,96.09,30,3.91,768
1,NSW,109,Yeoval,37,11.97,272,88.03,309,99.36,2,0.64,311
1,NSW,250,Yerong Creek,25,16.03,131,83.97,156,99.36,1,0.64,157
1,NSW,125,Yerrinbool,166,30.35,381,69.65,547,99.64,2,0.36,549
1,NSW,109,Yetholme,49,30.43,112,69.57,161,99.38,1,0.62,162
1,NSW,135,Yetman,3,3.7,78,96.3,81,100,0,0,81
1,NSW,118,Yoogali,106,14.38,631,85.62,737,99.33,5,0.67,742
1,NSW,250,Young,346,24.57,1062,75.43,1408,98.39,23,1.61,1431
1,NSW,250,Young North,58,20.71,222,79.29,280,97.9,6,2.1,286
1,NSW,250,Young PPVC,1067,17.54,5016,82.46,6083,98.94,65,1.06,6148
1,NSW,250,Young South,82,26.2,231,73.8,313,98.43,5,1.57,318
1,NSW,112,Yowie Bay,696,42.54,940,57.46,1636,99.21,13,0.79,1649
1,NSW,149,Zetland,794,70.02,340,29.98,1134,99.04,11,0.96,1145
1,NSW,149,Zetland South,1359,62.28,823,37.72,2182,99.09,20,0.91,2202
